,CrimeType,Capital,Demacro,Interior,Total,Date
0,HOMICÍDIO DOLOSO (exclui FEMINICÍDIO),6,6,13,25,2022-09-01
1,FEMINICÍDIO,4,4,5,13,2022-09-01
2,HOMICÍDIO DOLOSO - TOTAL,10,10,18,38,2022-09-01
3,HOMICÍDIO CULPOSO,0,0,0,0,2022-09-01
4,TENTATIVA DE HOMICÍDIO,6,8,24,38,2022-09-01
5,LESÃO CORPORAL DOLOSA,1299,699,2066,4064,2022-09-01
6,MAUS TRATOS,14,5,23,42,2022-09-01
7,CALÚNIA - DIFAMAÇÃO - INJÚRIA,2042,578,1882,4502,2022-09-01
8,CONSTRANGIMENTO ILEGAL,2,4,6,12,2022-09-01
9,AMEAÇA,2483,881,3592,6956,2022-09-01
10,INVASÃO DE DOMICÍLIO,66,28,92,186,2022-09-01
11,DANO,226,88,410,724,2022-09-01
12,ESTUPRO CONSUMADO,43,45,148,236,2022-09-01
13,ESTUPRO TENTADO,7,6,23,36,2022-09-01
14,ESTUPRO DE VULNERÁVEL CONSUMADO,177,173,480,830,2022-09-01
15,ESTUPRO DE VULNERÁVEL TENTADO,1,6,8,15,2022-09-01
16,OUTROS C/C/ DIGNIDADE SEXUAL,34,5,31,70,2022-09-01
17,HOMICÍDIO DOLOSO (exclui FEMINICÍDIO),4,3,6,13,2022-08-01
18,FEMINICÍDIO,4,6,6,16,2022-08-01
19,HOMICÍDIO DOLOSO - TOTAL,8,9,12,29,2022-08-01
20,HOMICÍDIO CULPOSO,0,0,0,0,2022-08-01
21,TENTATIVA DE HOMICÍDIO,4,7,41,52,2022-08-01
22,LESÃO CORPORAL DOLOSA,1508,672,3514,5694,2022-08-01
23,MAUS TRATOS,9,9,47,65,2022-08-01
24,CALÚNIA - DIFAMAÇÃO - INJÚRIA,2141,604,3302,6047,2022-08-01
25,CONSTRANGIMENTO ILEGAL,4,0,7,11,2022-08-01
26,AMEAÇA,2711,914,5712,9337,2022-08-01
27,INVASÃO DE DOMICÍLIO,59,23,130,212,2022-08-01
28,DANO,185,114,700,999,2022-08-01
29,ESTUPRO CONSUMADO,52,51,122,225,2022-08-01
30,ESTUPRO TENTADO,7,4,40,51,2022-08-01
31,ESTUPRO DE VULNERÁVEL CONSUMADO,176,172,533,881,2022-08-01
32,ESTUPRO DE VULNERÁVEL TENTADO,3,6,24,33,2022-08-01
33,OUTROS C/C/ DIGNIDADE SEXUAL,36,9,48,93,2022-08-01
34,HOMICÍDIO DOLOSO (exclui FEMINICÍDIO),2,6,9,17,2022-07-01
35,FEMINICÍDIO,3,6,11,20,2022-07-01
36,HOMICÍDIO DOLOSO - TOTAL,5,12,20,37,2022-07-01
37,HOMICÍDIO CULPOSO,0,0,0,0,2022-07-01
38,TENTATIVA DE HOMICÍDIO,7,3,25,35,2022-07-01
39,LESÃO CORPORAL DOLOSA,1456,698,1977,4131,2022-07-01
40,MAUS TRATOS,4,2,22,28,2022-07-01
41,CALÚNIA - DIFAMAÇÃO - INJÚRIA,2036,531,1872,4439,2022-07-01
42,CONSTRANGIMENTO ILEGAL,6,2,6,14,2022-07-01
43,AMEAÇA,2487,890,3504,6881,2022-07-01
44,INVASÃO DE DOMICÍLIO,58,11,88,157,2022-07-01
45,DANO,189,105,380,674,2022-07-01
46,ESTUPRO CONSUMADO,70,61,153,284,2022-07-01
47,ESTUPRO TENTADO,6,10,14,30,2022-07-01
48,ESTUPRO DE VULNERÁVEL CONSUMADO,182,203,514,899,2022-07-01
49,ESTUPRO DE VULNERÁVEL TENTADO,5,2,13,20,2022-07-01
50,OUTROS C/C/ DIGNIDADE SEXUAL,31,9,33,73,2022-07-01
51,HOMICÍDIO DOLOSO (exclui FEMINICÍDIO),2,3,15,20,2022-06-01
52,FEMINICÍDIO,1,2,8,11,2022-06-01
53,HOMICÍDIO DOLOSO - TOTAL,3,5,23,31,2022-06-01
54,HOMICÍDIO CULPOSO,0,0,0,0,2022-06-01
55,TENTATIVA DE HOMICÍDIO,3,0,18,21,2022-06-01
56,LESÃO CORPORAL DOLOSA,670,638,2156,3464,2022-06-01
57,MAUS TRATOS,3,2,26,31,2022-06-01
58,CALÚNIA - DIFAMAÇÃO - INJÚRIA,171,155,626,952,2022-06-01
59,CONSTRANGIMENTO ILEGAL,0,1,1,2,2022-06-01
60,AMEAÇA,777,616,3246,4639,2022-06-01
61,INVASÃO DE DOMICÍLIO,21,8,33,62,2022-06-01
62,DANO,17,22,78,117,2022-06-01
63,ESTUPRO CONSUMADO,51,39,119,209,2022-06-01
64,ESTUPRO TENTADO,6,4,29,39,2022-06-01
65,ESTUPRO DE VULNERÁVEL CONSUMADO,138,165,424,727,2022-06-01
66,ESTUPRO DE VULNERÁVEL TENTADO,4,4,12,20,2022-06-01
67,OUTROS C/C/ DIGNIDADE SEXUAL,17,8,42,67,2022-06-01
68,HOMICÍDIO DOLOSO (exclui FEMINICÍDIO),5,8,8,21,2022-05-01
69,FEMINICÍDIO,2,3,7,12,2022-05-01
70,HOMICÍDIO DOLOSO - TOTAL,7,11,15,33,2022-05-01
71,HOMICÍDIO CULPOSO,0,1,0,1,2022-05-01
72,TENTATIVA DE HOMICÍDIO,3,2,15,20,2022-05-01
73,LESÃO CORPORAL DOLOSA,819,730,2341,3890,2022-05-01
74,MAUS TRATOS,1,3,26,30,2022-05-01
75,CALÚNIA - DIFAMAÇÃO - INJÚRIA,280,197,673,1150,2022-05-01
76,CONSTRANGIMENTO ILEGAL,0,2,27,29,2022-05-01
77,AMEAÇA,776,665,3393,4834,2022-05-01
78,INVASÃO DE DOMICÍLIO,2,8,31,41,2022-05-01
79,DANO,16,20,59,95,2022-05-01
80,ESTUPRO CONSUMADO,55,57,115,227,2022-05-01
81,ESTUPRO TENTADO,11,11,20,42,2022-05-01
82,ESTUPRO DE VULNERÁVEL CONSUMADO,153,150,513,816,2022-05-01
83,ESTUPRO DE VULNERÁVEL TENTADO,0,8,17,25,2022-05-01
84,OUTROS C/C/ DIGNIDADE SEXUAL,23,10,25,58,2022-05-01
85,HOMICÍDIO DOLOSO (exclui FEMINICÍDIO),4,4,12,20,2022-04-01
86,FEMINICÍDIO,4,1,5,10,2022-04-01
87,HOMICÍDIO DOLOSO - TOTAL,8,5,17,30,2022-04-01
88,HOMICÍDIO CULPOSO,0,0,0,0,2022-04-01
89,TENTATIVA DE HOMICÍDIO,7,4,25,36,2022-04-01
90,LESÃO CORPORAL DOLOSA,843,718,2617,4178,2022-04-01
91,MAUS TRATOS,3,6,19,28,2022-04-01
92,CALÚNIA - DIFAMAÇÃO - INJÚRIA,376,149,652,1177,2022-04-01
93,CONSTRANGIMENTO ILEGAL,0,0,8,8,2022-04-01
94,AMEAÇA,815,635,3445,4895,2022-04-01
95,INVASÃO DE DOMICÍLIO,3,6,21,30,2022-04-01
96,DANO,15,17,60,92,2022-04-01
97,ESTUPRO CONSUMADO,58,44,141,243,2022-04-01
98,ESTUPRO TENTADO,8,6,24,38,2022-04-01
99,ESTUPRO DE VULNERÁVEL CONSUMADO,153,138,423,714,2022-04-01
100,ESTUPRO DE VULNERÁVEL TENTADO,1,3,18,22,2022-04-01
101,OUTROS C/C/ DIGNIDADE SEXUAL,14,7,25,46,2022-04-01
102,HOMICÍDIO DOLOSO (exclui FEMINICÍDIO),5,6,10,21,2022-03-01
103,FEMINICÍDIO,1,6,12,19,2022-03-01
104,HOMICÍDIO DOLOSO - TOTAL,6,12,22,40,2022-03-01
105,HOMICÍDIO CULPOSO,0,0,0,0,2022-03-01
106,TENTATIVA DE HOMICÍDIO,0,7,25,32,2022-03-01
107,LESÃO CORPORAL DOLOSA,1004,870,3197,5071,2022-03-01
108,MAUS TRATOS,4,2,29,35,2022-03-01
109,CALÚNIA - DIFAMAÇÃO - INJÚRIA,320,223,233,776,2022-03-01
110,CONSTRANGIMENTO ILEGAL,0,1,22,23,2022-03-01
111,AMEAÇA,992,800,4198,5990,2022-03-01
112,INVASÃO DE DOMICÍLIO,6,7,35,48,2022-03-01
113,DANO,19,20,82,121,2022-03-01
114,ESTUPRO CONSUMADO,54,47,122,223,2022-03-01
115,ESTUPRO TENTADO,2,10,31,43,2022-03-01
116,ESTUPRO DE VULNERÁVEL CONSUMADO,191,171,485,847,2022-03-01
117,ESTUPRO DE VULNERÁVEL TENTADO,0,1,17,18,2022-03-01
118,OUTROS C/C/ DIGNIDADE SEXUAL,26,15,37,78,2022-03-01
119,HOMICÍDIO DOLOSO (exclui FEMINICÍDIO),3,6,9,18,2022-02-01
120,FEMINICÍDIO,2,1,8,11,2022-02-01
121,HOMICÍDIO DOLOSO - TOTAL,5,7,17,29,2022-02-01
122,HOMICÍDIO CULPOSO,0,0,0,0,2022-02-01
123,TENTATIVA DE HOMICÍDIO,3,5,16,24,2022-02-01
124,LESÃO CORPORAL DOLOSA,898,1,2664,3563,2022-02-01
125,MAUS TRATOS,1,164,22,187,2022-02-01
126,CALÚNIA - DIFAMAÇÃO - INJÚRIA,268,0,612,880,2022-02-01
127,CONSTRANGIMENTO ILEGAL,0,718,11,729,2022-02-01
128,AMEAÇA,798,4,3153,3955,2022-02-01
129,INVASÃO DE DOMICÍLIO,2,10,21,33,2022-02-01
130,DANO,17,8,72,97,2022-02-01
131,ESTUPRO CONSUMADO,46,29,100,175,2022-02-01
132,ESTUPRO TENTADO,10,9,18,37,2022-02-01
133,ESTUPRO DE VULNERÁVEL CONSUMADO,108,145,345,598,2022-02-01
134,ESTUPRO DE VULNERÁVEL TENTADO,4,3,13,20,2022-02-01
135,OUTROS C/C/ DIGNIDADE SEXUAL,18,8,37,63,2022-02-01
136,HOMICÍDIO DOLOSO (exclui FEMINICÍDIO),7,10,9,26,2022-01-01
137,FEMINICÍDIO,0,3,9,12,2022-01-01
138,HOMICÍDIO DOLOSO - TOTAL,7,13,18,38,2022-01-01
139,HOMICÍDIO CULPOSO,0,0,0,0,2022-01-01
140,TENTATIVA DE HOMICÍDIO,2,9,13,24,2022-01-01
141,LESÃO CORPORAL DOLOSA,922,836,2710,4468,2022-01-01
142,MAUS TRATOS,5,4,18,27,2022-01-01
143,CALÚNIA - DIFAMAÇÃO - INJÚRIA,317,177,693,1187,2022-01-01
144,CONSTRANGIMENTO ILEGAL,0,3,5,8,2022-01-01
145,AMEAÇA,1016,631,3353,5000,2022-01-01
146,INVASÃO DE DOMICÍLIO,5,2,29,36,2022-01-01
147,DANO,17,12,75,104,2022-01-01
148,ESTUPRO CONSUMADO,45,29,117,191,2022-01-01
149,ESTUPRO TENTADO,13,7,18,38,2022-01-01
150,ESTUPRO DE VULNERÁVEL CONSUMADO,137,134,415,686,2022-01-01
151,ESTUPRO DE VULNERÁVEL TENTADO,0,4,6,10,2022-01-01
152,OUTROS C/C/ DIGNIDADE SEXUAL,25,6,31,62,2022-01-01
153,HOMICÍDIO DOLOSO (exclui FEMINICÍDIO),2,3,17,22,2021-12-01
154,FEMINICÍDIO,3,2,5,10,2021-12-01
155,HOMICÍDIO DOLOSO - TOTAL,5,5,22,32,2021-12-01
156,HOMICÍDIO CULPOSO,0,0,0,0,2021-12-01
157,TENTATIVA DE HOMICÍDIO,2,5,28,35,2021-12-01
158,LESÃO CORPORAL DOLOSA,952,813,2929,4694,2021-12-01
159,MAUS TRATOS,4,5,25,34,2021-12-01
160,CALÚNIA - DIFAMAÇÃO - INJÚRIA,257,199,667,1123,2021-12-01
161,CONSTRANGIMENTO ILEGAL,18,1,0,19,2021-12-01
162,AMEAÇA,836,679,3556,5071,2021-12-01
163,INVASÃO DE DOMICÍLIO,1,8,23,32,2021-12-01
164,DANO,15,19,91,125,2021-12-01
165,ESTUPRO CONSUMADO,33,25,131,189,2021-12-01
166,ESTUPRO TENTADO,10,10,17,37,2021-12-01
167,ESTUPRO DE VULNERÁVEL CONSUMADO,108,144,373,625,2021-12-01
168,ESTUPRO DE VULNERÁVEL TENTADO,5,5,12,22,2021-12-01
169,OUTROS C/C/ DIGNIDADE SEXUAL,20,10,42,72,2021-12-01
170,HOMICÍDIO DOLOSO (exclui FEMINICÍDIO),4,1,7,12,2021-11-01
171,FEMINICÍDIO,1,0,8,9,2021-11-01
172,HOMICÍDIO DOLOSO - TOTAL,5,1,15,21,2021-11-01
173,HOMICÍDIO CULPOSO,0,0,0,0,2021-11-01
174,TENTATIVA DE HOMICÍDIO,5,10,25,40,2021-11-01
175,LESÃO CORPORAL DOLOSA,941,780,2831,4552,2021-11-01
176,MAUS TRATOS,5,2,29,36,2021-11-01
177,CALÚNIA - DIFAMAÇÃO - INJÚRIA,305,197,647,1149,2021-11-01
178,CONSTRANGIMENTO ILEGAL,0,1,8,9,2021-11-01
179,AMEAÇA,830,785,3496,5111,2021-11-01
180,INVASÃO DE DOMICÍLIO,3,13,27,43,2021-11-01
181,DANO,11,19,93,123,2021-11-01
182,ESTUPRO CONSUMADO,56,35,131,222,2021-11-01
183,ESTUPRO TENTADO,11,7,24,42,2021-11-01
184,ESTUPRO DE VULNERÁVEL CONSUMADO,138,155,476,769,2021-11-01
185,ESTUPRO DE VULNERÁVEL TENTADO,2,2,12,16,2021-11-01
186,OUTROS C/C/ DIGNIDADE SEXUAL,61,10,37,108,2021-11-01
187,HOMICÍDIO DOLOSO (exclui FEMINICÍDIO),2,3,9,14,2021-10-01
188,FEMINICÍDIO,3,1,5,9,2021-10-01
189,HOMICÍDIO DOLOSO - TOTAL,5,4,14,23,2021-10-01
190,HOMICÍDIO CULPOSO,0,0,0,0,2021-10-01
191,TENTATIVA DE HOMICÍDIO,1,5,19,25,2021-10-01
192,LESÃO CORPORAL DOLOSA,783,816,2682,4281,2021-10-01
193,MAUS TRATOS,2,1,22,25,2021-10-01
194,CALÚNIA - DIFAMAÇÃO - INJÚRIA,248,152,576,976,2021-10-01
195,CONSTRANGIMENTO ILEGAL,0,2,6,8,2021-10-01
196,AMEAÇA,836,671,3171,4678,2021-10-01
197,INVASÃO DE DOMICÍLIO,5,7,35,47,2021-10-01
198,DANO,12,9,81,102,2021-10-01
199,ESTUPRO CONSUMADO,57,26,116,199,2021-10-01
200,ESTUPRO TENTADO,9,8,27,44,2021-10-01
201,ESTUPRO DE VULNERÁVEL CONSUMADO,141,153,377,671,2021-10-01
202,ESTUPRO DE VULNERÁVEL TENTADO,7,6,11,24,2021-10-01
203,OUTROS C/C/ DIGNIDADE SEXUAL,25,13,31,69,2021-10-01
204,HOMICÍDIO DOLOSO (exclui FEMINICÍDIO),7,5,11,23,2021-09-01
205,FEMINICÍDIO,3,1,2,6,2021-09-01
206,HOMICÍDIO DOLOSO - TOTAL,10,6,13,29,2021-09-01
207,HOMICÍDIO CULPOSO,0,0,0,0,2021-09-01
208,TENTATIVA DE HOMICÍDIO,1,4,20,25,2021-09-01
209,LESÃO CORPORAL DOLOSA,904,872,2787,4563,2021-09-01
210,MAUS TRATOS,2,3,30,35,2021-09-01
211,CALÚNIA - DIFAMAÇÃO - INJÚRIA,259,187,638,1084,2021-09-01
212,CONSTRANGIMENTO ILEGAL,0,1,6,7,2021-09-01
213,AMEAÇA,855,744,3461,5060,2021-09-01
214,INVASÃO DE DOMICÍLIO,6,4,20,30,2021-09-01
215,DANO,8,18,73,99,2021-09-01
216,ESTUPRO CONSUMADO,49,35,99,183,2021-09-01
217,ESTUPRO TENTADO,12,13,26,51,2021-09-01
218,ESTUPRO DE VULNERÁVEL CONSUMADO,138,130,425,693,2021-09-01
219,ESTUPRO DE VULNERÁVEL TENTADO,12,4,12,28,2021-09-01
220,OUTROS C/C/ DIGNIDADE SEXUAL,17,18,28,63,2021-09-01
221,HOMICÍDIO DOLOSO (exclui FEMINICÍDIO),4,3,15,22,2021-08-01
222,FEMINICÍDIO,1,2,5,8,2021-08-01
223,HOMICÍDIO DOLOSO - TOTAL,5,5,20,30,2021-08-01
224,HOMICÍDIO CULPOSO,0,0,0,0,2021-08-01
225,TENTATIVA DE HOMICÍDIO,2,4,15,21,2021-08-01
226,LESÃO CORPORAL DOLOSA,979,878,2701,4558,2021-08-01
227,MAUS TRATOS,7,8,29,44,2021-08-01
228,CALÚNIA - DIFAMAÇÃO - INJÚRIA,358,192,639,1189,2021-08-01
229,CONSTRANGIMENTO ILEGAL,2,21,5,28,2021-08-01
230,AMEAÇA,1027,822,3535,5384,2021-08-01
231,INVASÃO DE DOMICÍLIO,10,6,34,50,2021-08-01
232,DANO,13,15,75,103,2021-08-01
233,ESTUPRO CONSUMADO,46,39,103,188,2021-08-01
234,ESTUPRO TENTADO,8,7,24,39,2021-08-01
235,ESTUPRO DE VULNERÁVEL CONSUMADO,139,138,373,650,2021-08-01
236,ESTUPRO DE VULNERÁVEL TENTADO,0,2,14,16,2021-08-01
237,OUTROS C/C/ DIGNIDADE SEXUAL,39,7,39,85,2021-08-01
238,HOMICÍDIO DOLOSO (exclui FEMINICÍDIO),6,4,12,22,2021-07-01
239,FEMINICÍDIO,2,2,4,8,2021-07-01
240,HOMICÍDIO DOLOSO - TOTAL,8,6,16,30,2021-07-01
241,HOMICÍDIO CULPOSO,0,0,0,0,2021-07-01
242,TENTATIVA DE HOMICÍDIO,2,7,19,28,2021-07-01
243,LESÃO CORPORAL DOLOSA,889,733,2319,3941,2021-07-01
244,MAUS TRATOS,0,6,22,28,2021-07-01
245,CALÚNIA - DIFAMAÇÃO - INJÚRIA,215,143,543,901,2021-07-01
246,CONSTRANGIMENTO ILEGAL,96,2,10,108,2021-07-01
247,AMEAÇA,621,655,2979,4255,2021-07-01
248,INVASÃO DE DOMICÍLIO,5,12,24,41,2021-07-01
249,DANO,12,9,60,81,2021-07-01
250,ESTUPRO CONSUMADO,45,24,93,162,2021-07-01
251,ESTUPRO TENTADO,10,9,20,39,2021-07-01
252,ESTUPRO DE VULNERÁVEL CONSUMADO,148,115,322,585,2021-07-01
253,ESTUPRO DE VULNERÁVEL TENTADO,3,2,12,17,2021-07-01
254,OUTROS C/C/ DIGNIDADE SEXUAL,36,7,25,68,2021-07-01
255,HOMICÍDIO DOLOSO (exclui FEMINICÍDIO),7,0,8,15,2021-06-01
256,FEMINICÍDIO,2,0,5,7,2021-06-01
257,HOMICÍDIO DOLOSO - TOTAL,9,0,13,22,2021-06-01
258,HOMICÍDIO CULPOSO,0,0,0,0,2021-06-01
259,TENTATIVA DE HOMICÍDIO,3,3,22,28,2021-06-01
260,LESÃO CORPORAL DOLOSA,707,760,2242,3709,2021-06-01
261,MAUS TRATOS,5,3,24,32,2021-06-01
262,CALÚNIA - DIFAMAÇÃO - INJÚRIA,248,110,464,822,2021-06-01
263,CONSTRANGIMENTO ILEGAL,1,1,13,15,2021-06-01
264,AMEAÇA,757,666,2842,4265,2021-06-01
265,INVASÃO DE DOMICÍLIO,8,7,18,33,2021-06-01
266,DANO,14,17,58,89,2021-06-01
267,ESTUPRO CONSUMADO,42,43,85,170,2021-06-01
268,ESTUPRO TENTADO,5,10,18,33,2021-06-01
269,ESTUPRO DE VULNERÁVEL CONSUMADO,136,166,300,602,2021-06-01
270,ESTUPRO DE VULNERÁVEL TENTADO,1,5,20,26,2021-06-01
271,OUTROS C/C/ DIGNIDADE SEXUAL,27,9,42,78,2021-06-01
272,HOMICÍDIO DOLOSO (exclui FEMINICÍDIO),2,4,11,17,2021-05-01
273,FEMINICÍDIO,5,3,18,26,2021-05-01
274,HOMICÍDIO DOLOSO - TOTAL,7,7,29,43,2021-05-01
275,HOMICÍDIO CULPOSO,0,0,0,0,2021-05-01
276,TENTATIVA DE HOMICÍDIO,3,2,14,19,2021-05-01
277,LESÃO CORPORAL DOLOSA,695,761,2358,3814,2021-05-01
278,MAUS TRATOS,8,4,29,41,2021-05-01
279,CALÚNIA - DIFAMAÇÃO - INJÚRIA,236,158,495,889,2021-05-01
280,CONSTRANGIMENTO ILEGAL,1,0,5,6,2021-05-01
281,AMEAÇA,732,675,2991,4398,2021-05-01
282,INVASÃO DE DOMICÍLIO,2,11,28,41,2021-05-01
283,DANO,21,6,57,84,2021-05-01
284,ESTUPRO CONSUMADO,41,25,87,153,2021-05-01
285,ESTUPRO TENTADO,11,12,24,47,2021-05-01
286,ESTUPRO DE VULNERÁVEL CONSUMADO,123,120,419,662,2021-05-01
287,ESTUPRO DE VULNERÁVEL TENTADO,0,4,9,13,2021-05-01
288,OUTROS C/C/ DIGNIDADE SEXUAL,15,12,34,61,2021-05-01
289,HOMICÍDIO DOLOSO (exclui FEMINICÍDIO),10,8,7,25,2021-04-01
290,FEMINICÍDIO,3,1,6,10,2021-04-01
291,HOMICÍDIO DOLOSO - TOTAL,13,9,13,35,2021-04-01
292,HOMICÍDIO CULPOSO,0,0,0,0,2021-04-01
293,TENTATIVA DE HOMICÍDIO,11,7,18,36,2021-04-01
294,LESÃO CORPORAL DOLOSA,771,687,2398,3856,2021-04-01
295,MAUS TRATOS,7,5,45,57,2021-04-01
296,CALÚNIA - DIFAMAÇÃO - INJÚRIA,210,149,566,925,2021-04-01
297,CONSTRANGIMENTO ILEGAL,1,0,13,14,2021-04-01
298,AMEAÇA,768,619,3160,4547,2021-04-01
299,INVASÃO DE DOMICÍLIO,3,13,28,44,2021-04-01
300,DANO,5,16,55,76,2021-04-01
301,ESTUPRO CONSUMADO,30,44,104,178,2021-04-01
302,ESTUPRO TENTADO,7,6,18,31,2021-04-01
303,ESTUPRO DE VULNERÁVEL CONSUMADO,133,126,404,663,2021-04-01
304,ESTUPRO DE VULNERÁVEL TENTADO,1,4,14,19,2021-04-01
305,OUTROS C/C/ DIGNIDADE SEXUAL,19,7,28,54,2021-04-01
306,HOMICÍDIO DOLOSO (exclui FEMINICÍDIO),2,3,13,18,2021-03-01
307,FEMINICÍDIO,4,2,15,21,2021-03-01
308,HOMICÍDIO DOLOSO - TOTAL,6,5,28,39,2021-03-01
309,HOMICÍDIO CULPOSO,0,0,0,0,2021-03-01
310,TENTATIVA DE HOMICÍDIO,4,5,19,28,2021-03-01
311,LESÃO CORPORAL DOLOSA,890,854,2907,4651,2021-03-01
312,MAUS TRATOS,5,4,23,32,2021-03-01
313,CALÚNIA - DIFAMAÇÃO - INJÚRIA,185,186,599,970,2021-03-01
314,CONSTRANGIMENTO ILEGAL,2,0,3,5,2021-03-01
315,AMEAÇA,903,790,3370,5063,2021-03-01
316,INVASÃO DE DOMICÍLIO,2,11,24,37,2021-03-01
317,DANO,15,24,54,93,2021-03-01
318,ESTUPRO CONSUMADO,62,40,146,248,2021-03-01
319,ESTUPRO TENTADO,12,12,23,47,2021-03-01
320,ESTUPRO DE VULNERÁVEL CONSUMADO,137,172,436,745,2021-03-01
321,ESTUPRO DE VULNERÁVEL TENTADO,4,2,13,19,2021-03-01
322,OUTROS C/C/ DIGNIDADE SEXUAL,6,8,31,45,2021-03-01
323,HOMICÍDIO DOLOSO (exclui FEMINICÍDIO),2,2,17,21,2021-02-01
324,FEMINICÍDIO,3,1,7,11,2021-02-01
325,HOMICÍDIO DOLOSO - TOTAL,5,3,24,32,2021-02-01
326,HOMICÍDIO CULPOSO,0,0,0,0,2021-02-01
327,TENTATIVA DE HOMICÍDIO,5,8,11,24,2021-02-01
328,LESÃO CORPORAL DOLOSA,975,801,2590,4366,2021-02-01
329,MAUS TRATOS,1,0,23,24,2021-02-01
330,CALÚNIA - DIFAMAÇÃO - INJÚRIA,244,162,648,1054,2021-02-01
331,CONSTRANGIMENTO ILEGAL,1,1,8,10,2021-02-01
332,AMEAÇA,986,703,3306,4995,2021-02-01
333,INVASÃO DE DOMICÍLIO,8,6,10,24,2021-02-01
334,DANO,10,8,61,79,2021-02-01
335,ESTUPRO CONSUMADO,58,40,150,248,2021-02-01
336,ESTUPRO TENTADO,12,7,25,44,2021-02-01
337,ESTUPRO DE VULNERÁVEL CONSUMADO,178,183,469,830,2021-02-01
338,ESTUPRO DE VULNERÁVEL TENTADO,2,5,9,16,2021-02-01
339,OUTROS C/C/ DIGNIDADE SEXUAL,36,6,24,66,2021-02-01
340,HOMICÍDIO DOLOSO (exclui FEMINICÍDIO),6,3,10,19,2021-01-01
341,FEMINICÍDIO,3,1,7,11,2021-01-01
342,HOMICÍDIO DOLOSO - TOTAL,9,4,17,30,2021-01-01
343,HOMICÍDIO CULPOSO,0,0,0,0,2021-01-01
344,TENTATIVA DE HOMICÍDIO,3,4,20,27,2021-01-01
345,LESÃO CORPORAL DOLOSA,994,846,3130,4970,2021-01-01
346,MAUS TRATOS,2,1,38,41,2021-01-01
347,CALÚNIA - DIFAMAÇÃO - INJÚRIA,180,148,655,983,2021-01-01
348,CONSTRANGIMENTO ILEGAL,63,0,4,67,2021-01-01
349,AMEAÇA,1010,844,3658,5512,2021-01-01
350,INVASÃO DE DOMICÍLIO,8,7,25,40,2021-01-01
351,DANO,20,20,79,119,2021-01-01
352,ESTUPRO CONSUMADO,60,52,120,232,2021-01-01
353,ESTUPRO TENTADO,10,12,33,55,2021-01-01
354,ESTUPRO DE VULNERÁVEL CONSUMADO,141,169,467,777,2021-01-01
355,ESTUPRO DE VULNERÁVEL TENTADO,4,5,15,24,2021-01-01
356,OUTROS C/C/ DIGNIDADE SEXUAL,13,6,36,55,2021-01-01
357,HOMICÍDIO DOLOSO (exclui FEMINICÍDIO),7,6,11,24,2020-12-01
358,FEMINICÍDIO,6,4,9,19,2020-12-01
359,HOMICÍDIO DOLOSO - TOTAL,13,10,20,43,2020-12-01
360,HOMICÍDIO CULPOSO,0,0,0,0,2020-12-01
361,TENTATIVA DE HOMICÍDIO,5,3,19,27,2020-12-01
362,LESÃO CORPORAL DOLOSA,918,802,2826,4546,2020-12-01
363,MAUS TRATOS,3,4,23,30,2020-12-01
364,CALÚNIA - DIFAMAÇÃO - INJÚRIA,252,177,584,1013,2020-12-01
365,CONSTRANGIMENTO ILEGAL,0,0,4,4,2020-12-01
366,AMEAÇA,811,636,3288,4735,2020-12-01
367,INVASÃO DE DOMICÍLIO,2,4,25,31,2020-12-01
368,DANO,7,19,45,71,2020-12-01
369,ESTUPRO CONSUMADO,48,39,115,202,2020-12-01
370,ESTUPRO TENTADO,12,7,30,49,2020-12-01
371,ESTUPRO DE VULNERÁVEL CONSUMADO,157,163,413,733,2020-12-01
372,ESTUPRO DE VULNERÁVEL TENTADO,4,8,15,27,2020-12-01
373,OUTROS C/C/ DIGNIDADE SEXUAL,10,6,29,45,2020-12-01
374,HOMICÍDIO DOLOSO (exclui FEMINICÍDIO),5,4,13,22,2020-11-01
375,FEMINICÍDIO,4,5,11,20,2020-11-01
376,HOMICÍDIO DOLOSO - TOTAL,9,9,24,42,2020-11-01
377,HOMICÍDIO CULPOSO,0,0,0,0,2020-11-01
378,TENTATIVA DE HOMICÍDIO,8,3,26,37,2020-11-01
379,LESÃO CORPORAL DOLOSA,862,824,2981,4667,2020-11-01
380,MAUS TRATOS,3,3,28,34,2020-11-01
381,CALÚNIA - DIFAMAÇÃO - INJÚRIA,233,119,566,918,2020-11-01
382,CONSTRANGIMENTO ILEGAL,1,0,8,9,2020-11-01
383,AMEAÇA,754,676,3529,4959,2020-11-01
384,INVASÃO DE DOMICÍLIO,1,1,58,60,2020-11-01
385,DANO,8,7,68,83,2020-11-01
386,ESTUPRO CONSUMADO,53,47,128,228,2020-11-01
387,ESTUPRO TENTADO,11,10,28,49,2020-11-01
388,ESTUPRO DE VULNERÁVEL CONSUMADO,152,149,462,763,2020-11-01
389,ESTUPRO DE VULNERÁVEL TENTADO,1,3,11,15,2020-11-01
390,OUTROS C/C/ DIGNIDADE SEXUAL,12,5,37,54,2020-11-01
391,HOMICÍDIO DOLOSO (exclui FEMINICÍDIO),3,7,15,25,2020-10-01
392,FEMINICÍDIO,5,2,7,14,2020-10-01
393,HOMICÍDIO DOLOSO - TOTAL,8,9,22,39,2020-10-01
394,HOMICÍDIO CULPOSO,0,0,0,0,2020-10-01
395,TENTATIVA DE HOMICÍDIO,1,10,22,33,2020-10-01
396,LESÃO CORPORAL DOLOSA,930,785,2919,4634,2020-10-01
397,MAUS TRATOS,2,1,25,28,2020-10-01
398,CALÚNIA - DIFAMAÇÃO - INJÚRIA,365,130,596,1091,2020-10-01
399,CONSTRANGIMENTO ILEGAL,4,35,15,54,2020-10-01
400,AMEAÇA,826,706,3406,4938,2020-10-01
401,INVASÃO DE DOMICÍLIO,15,6,30,51,2020-10-01
402,DANO,13,11,59,83,2020-10-01
403,ESTUPRO CONSUMADO,56,35,137,228,2020-10-01
404,ESTUPRO TENTADO,6,10,23,39,2020-10-01
405,ESTUPRO DE VULNERÁVEL CONSUMADO,140,143,425,708,2020-10-01
406,ESTUPRO DE VULNERÁVEL TENTADO,5,5,19,29,2020-10-01
407,OUTROS C/C/ DIGNIDADE SEXUAL,26,4,25,55,2020-10-01
408,HOMICÍDIO DOLOSO (exclui FEMINICÍDIO),5,6,15,26,2020-09-01
409,FEMINICÍDIO,4,4,9,17,2020-09-01
410,HOMICÍDIO DOLOSO - TOTAL,9,10,24,43,2020-09-01
411,HOMICÍDIO CULPOSO,0,0,0,0,2020-09-01
412,TENTATIVA DE HOMICÍDIO,3,8,15,26,2020-09-01
413,LESÃO CORPORAL DOLOSA,718,844,2747,4309,2020-09-01
414,MAUS TRATOS,2,1,29,32,2020-09-01
415,CALÚNIA - DIFAMAÇÃO - INJÚRIA,231,140,632,1003,2020-09-01
416,CONSTRANGIMENTO ILEGAL,13,0,12,25,2020-09-01
417,AMEAÇA,728,780,3495,5003,2020-09-01
418,INVASÃO DE DOMICÍLIO,3,2,19,24,2020-09-01
419,DANO,6,12,66,84,2020-09-01
420,ESTUPRO CONSUMADO,45,52,123,220,2020-09-01
421,ESTUPRO TENTADO,9,12,31,52,2020-09-01
422,ESTUPRO DE VULNERÁVEL CONSUMADO,163,172,457,792,2020-09-01
423,ESTUPRO DE VULNERÁVEL TENTADO,2,9,13,24,2020-09-01
424,OUTROS C/C/ DIGNIDADE SEXUAL,9,1,24,34,2020-09-01
425,HOMICÍDIO DOLOSO (exclui FEMINICÍDIO),2,3,17,22,2020-08-01
426,FEMINICÍDIO,2,2,4,8,2020-08-01
427,HOMICÍDIO DOLOSO - TOTAL,4,5,21,30,2020-08-01
428,HOMICÍDIO CULPOSO,0,0,0,0,2020-08-01
429,TENTATIVA DE HOMICÍDIO,3,9,20,32,2020-08-01
430,LESÃO CORPORAL DOLOSA,698,663,2453,3814,2020-08-01
431,MAUS TRATOS,0,2,26,28,2020-08-01
432,CALÚNIA - DIFAMAÇÃO - INJÚRIA,183,127,602,912,2020-08-01
433,CONSTRANGIMENTO ILEGAL,7,2,4,13,2020-08-01
434,AMEAÇA,669,696,3123,4488,2020-08-01
435,INVASÃO DE DOMICÍLIO,4,7,27,38,2020-08-01
436,DANO,14,14,56,84,2020-08-01
437,ESTUPRO CONSUMADO,40,40,126,206,2020-08-01
438,ESTUPRO TENTADO,6,11,30,47,2020-08-01
439,ESTUPRO DE VULNERÁVEL CONSUMADO,138,150,427,715,2020-08-01
440,ESTUPRO DE VULNERÁVEL TENTADO,0,6,17,23,2020-08-01
441,OUTROS C/C/ DIGNIDADE SEXUAL,8,3,24,35,2020-08-01
442,HOMICÍDIO DOLOSO (exclui FEMINICÍDIO),6,3,9,18,2020-07-01
443,FEMINICÍDIO,3,1,9,13,2020-07-01
444,HOMICÍDIO DOLOSO - TOTAL,9,4,18,31,2020-07-01
445,HOMICÍDIO CULPOSO,0,0,0,0,2020-07-01
446,TENTATIVA DE HOMICÍDIO,4,7,21,32,2020-07-01
447,LESÃO CORPORAL DOLOSA,624,756,2446,3826,2020-07-01
448,MAUS TRATOS,3,6,24,33,2020-07-01
449,CALÚNIA - DIFAMAÇÃO - INJÚRIA,164,152,541,857,2020-07-01
450,CONSTRANGIMENTO ILEGAL,0,0,6,6,2020-07-01
451,AMEAÇA,630,749,3025,4404,2020-07-01
452,INVASÃO DE DOMICÍLIO,5,9,32,46,2020-07-01
453,DANO,10,10,34,54,2020-07-01
454,ESTUPRO CONSUMADO,46,52,115,213,2020-07-01
455,ESTUPRO TENTADO,7,14,34,55,2020-07-01
456,ESTUPRO DE VULNERÁVEL CONSUMADO,145,150,370,665,2020-07-01
457,ESTUPRO DE VULNERÁVEL TENTADO,9,1,19,29,2020-07-01
458,OUTROS C/C/ DIGNIDADE SEXUAL,1,1,27,29,2020-07-01
459,HOMICÍDIO DOLOSO (exclui FEMINICÍDIO),5,5,11,21,2020-06-01
460,FEMINICÍDIO,1,2,5,8,2020-06-01
461,HOMICÍDIO DOLOSO - TOTAL,6,7,16,29,2020-06-01
462,HOMICÍDIO CULPOSO,0,0,1,1,2020-06-01
463,TENTATIVA DE HOMICÍDIO,3,5,18,26,2020-06-01
464,LESÃO CORPORAL DOLOSA,692,665,2347,3704,2020-06-01
465,MAUS TRATOS,1,3,15,19,2020-06-01
466,CALÚNIA - DIFAMAÇÃO - INJÚRIA,185,135,486,806,2020-06-01
467,CONSTRANGIMENTO ILEGAL,1,10,9,20,2020-06-01
468,AMEAÇA,713,627,3051,4391,2020-06-01
469,INVASÃO DE DOMICÍLIO,4,3,18,25,2020-06-01
470,DANO,3,7,55,65,2020-06-01
471,ESTUPRO CONSUMADO,42,34,116,192,2020-06-01
472,ESTUPRO TENTADO,10,17,29,56,2020-06-01
473,ESTUPRO DE VULNERÁVEL CONSUMADO,139,123,366,628,2020-06-01
474,ESTUPRO DE VULNERÁVEL TENTADO,1,5,14,20,2020-06-01
475,OUTROS C/C/ DIGNIDADE SEXUAL,12,3,30,45,2020-06-01
476,HOMICÍDIO DOLOSO (exclui FEMINICÍDIO),5,5,9,19,2020-05-01
477,FEMINICÍDIO,1,1,7,9,2020-05-01
478,HOMICÍDIO DOLOSO - TOTAL,6,6,16,28,2020-05-01
479,HOMICÍDIO CULPOSO,0,0,0,0,2020-05-01
480,TENTATIVA DE HOMICÍDIO,6,2,15,23,2020-05-01
481,LESÃO CORPORAL DOLOSA,599,540,2098,3237,2020-05-01
482,MAUS TRATOS,3,3,21,27,2020-05-01
483,CALÚNIA - DIFAMAÇÃO - INJÚRIA,117,99,370,586,2020-05-01
484,CONSTRANGIMENTO ILEGAL,0,0,3,3,2020-05-01
485,AMEAÇA,490,523,2519,3532,2020-05-01
486,INVASÃO DE DOMICÍLIO,0,3,26,29,2020-05-01
487,DANO,9,8,44,61,2020-05-01
488,ESTUPRO CONSUMADO,30,25,99,154,2020-05-01
489,ESTUPRO TENTADO,8,10,33,51,2020-05-01
490,ESTUPRO DE VULNERÁVEL CONSUMADO,90,106,308,504,2020-05-01
491,ESTUPRO DE VULNERÁVEL TENTADO,2,2,2,6,2020-05-01
492,OUTROS C/C/ DIGNIDADE SEXUAL,7,2,17,26,2020-05-01
493,HOMICÍDIO DOLOSO (exclui FEMINICÍDIO),2,6,7,15,2020-04-01
494,FEMINICÍDIO,3,2,16,21,2020-04-01
495,HOMICÍDIO DOLOSO - TOTAL,5,8,23,36,2020-04-01
496,HOMICÍDIO CULPOSO,0,0,0,0,2020-04-01
497,TENTATIVA DE HOMICÍDIO,3,4,14,21,2020-04-01
498,LESÃO CORPORAL DOLOSA,594,634,2016,3244,2020-04-01
499,MAUS TRATOS,2,1,8,11,2020-04-01
500,CALÚNIA - DIFAMAÇÃO - INJÚRIA,78,88,304,470,2020-04-01
501,CONSTRANGIMENTO ILEGAL,0,1,3,4,2020-04-01
502,AMEAÇA,406,457,2156,3019,2020-04-01
503,INVASÃO DE DOMICÍLIO,4,2,9,15,2020-04-01
504,DANO,5,7,52,64,2020-04-01
505,ESTUPRO CONSUMADO,35,28,115,178,2020-04-01
506,ESTUPRO TENTADO,4,3,28,35,2020-04-01
507,ESTUPRO DE VULNERÁVEL CONSUMADO,87,103,266,456,2020-04-01
508,ESTUPRO DE VULNERÁVEL TENTADO,2,0,8,10,2020-04-01
509,OUTROS C/C/ DIGNIDADE SEXUAL,4,2,16,22,2020-04-01
510,HOMICÍDIO DOLOSO (exclui FEMINICÍDIO),4,2,10,16,2020-03-01
511,FEMINICÍDIO,2,6,12,20,2020-03-01
512,HOMICÍDIO DOLOSO - TOTAL,6,8,22,36,2020-03-01
513,HOMICÍDIO CULPOSO,0,0,0,0,2020-03-01
514,TENTATIVA DE HOMICÍDIO,12,8,19,39,2020-03-01
515,LESÃO CORPORAL DOLOSA,926,730,2673,4329,2020-03-01
516,MAUS TRATOS,2,6,20,28,2020-03-01
517,CALÚNIA - DIFAMAÇÃO - INJÚRIA,260,130,513,903,2020-03-01
518,CONSTRANGIMENTO ILEGAL,50,0,3,53,2020-03-01
519,AMEAÇA,783,771,3088,4642,2020-03-01
520,INVASÃO DE DOMICÍLIO,1,5,25,31,2020-03-01
521,DANO,9,15,53,77,2020-03-01
522,ESTUPRO CONSUMADO,61,43,126,230,2020-03-01
523,ESTUPRO TENTADO,8,7,21,36,2020-03-01
524,ESTUPRO DE VULNERÁVEL CONSUMADO,128,140,365,633,2020-03-01
525,ESTUPRO DE VULNERÁVEL TENTADO,2,7,14,23,2020-03-01
526,OUTROS C/C/ DIGNIDADE SEXUAL,18,4,13,35,2020-03-01
527,HOMICÍDIO DOLOSO (exclui FEMINICÍDIO),3,3,10,16,2020-02-01
528,FEMINICÍDIO,5,3,10,18,2020-02-01
529,HOMICÍDIO DOLOSO - TOTAL,8,6,20,34,2020-02-01
530,HOMICÍDIO CULPOSO,0,0,0,0,2020-02-01
531,TENTATIVA DE HOMICÍDIO,10,4,18,32,2020-02-01
532,LESÃO CORPORAL DOLOSA,1034,872,2707,4613,2020-02-01
533,MAUS TRATOS,5,3,15,23,2020-02-01
534,CALÚNIA - DIFAMAÇÃO - INJÚRIA,273,193,615,1081,2020-02-01
535,CONSTRANGIMENTO ILEGAL,0,1,13,14,2020-02-01
536,AMEAÇA,957,762,3343,5062,2020-02-01
537,INVASÃO DE DOMICÍLIO,0,2,22,24,2020-02-01
538,DANO,13,20,57,90,2020-02-01
539,ESTUPRO CONSUMADO,50,48,146,244,2020-02-01
540,ESTUPRO TENTADO,8,5,39,52,2020-02-01
541,ESTUPRO DE VULNERÁVEL CONSUMADO,144,127,344,615,2020-02-01
542,ESTUPRO DE VULNERÁVEL TENTADO,4,5,10,19,2020-02-01
543,OUTROS C/C/ DIGNIDADE SEXUAL,12,3,20,35,2020-02-01
544,HOMICÍDIO DOLOSO (exclui FEMINICÍDIO),6,6,9,21,2020-01-01
545,FEMINICÍDIO,4,1,7,12,2020-01-01
546,HOMICÍDIO DOLOSO - TOTAL,10,7,16,33,2020-01-01
547,HOMICÍDIO CULPOSO,2,0,0,2,2020-01-01
548,TENTATIVA DE HOMICÍDIO,8,8,24,40,2020-01-01
549,LESÃO CORPORAL DOLOSA,977,903,3062,4942,2020-01-01
550,MAUS TRATOS,2,0,24,26,2020-01-01
551,CALÚNIA - DIFAMAÇÃO - INJÚRIA,216,199,750,1165,2020-01-01
552,CONSTRANGIMENTO ILEGAL,1,0,12,13,2020-01-01
553,AMEAÇA,1017,1050,3917,5984,2020-01-01
554,INVASÃO DE DOMICÍLIO,5,2,12,19,2020-01-01
555,DANO,16,19,69,104,2020-01-01
556,ESTUPRO CONSUMADO,64,47,152,263,2020-01-01
557,ESTUPRO TENTADO,13,16,40,69,2020-01-01
558,ESTUPRO DE VULNERÁVEL CONSUMADO,144,157,416,717,2020-01-01
559,ESTUPRO DE VULNERÁVEL TENTADO,5,4,9,18,2020-01-01
560,OUTROS C/C/ DIGNIDADE SEXUAL,12,5,28,45,2020-01-01
561,HOMICÍDIO DOLOSO (exclui FEMINICÍDIO),3,3,28,34,2019-12-01
562,FEMINICÍDIO,6,3,18,27,2019-12-01
563,HOMICÍDIO DOLOSO - TOTAL,9,6,46,61,2019-12-01
564,HOMICÍDIO CULPOSO,0,0,0,0,2019-12-01
565,TENTATIVA DE HOMICÍDIO,7,9,9,25,2019-12-01
566,LESÃO CORPORAL DOLOSA,1062,842,2946,4850,2019-12-01
567,MAUS TRATOS,7,4,10,21,2019-12-01
568,CALÚNIA - DIFAMAÇÃO - INJÚRIA,259,147,575,981,2019-12-01
569,CONSTRANGIMENTO ILEGAL,0,1,2,3,2019-12-01
570,AMEAÇA,860,768,3272,4900,2019-12-01
571,INVASÃO DE DOMICÍLIO,4,3,13,20,2019-12-01
572,DANO,10,11,58,79,2019-12-01
573,ESTUPRO CONSUMADO,50,55,148,253,2019-12-01
574,ESTUPRO TENTADO,11,12,26,49,2019-12-01
575,ESTUPRO DE VULNERÁVEL CONSUMADO,131,121,348,600,2019-12-01
576,ESTUPRO DE VULNERÁVEL TENTADO,1,7,10,18,2019-12-01
577,OUTROS C/C/ DIGNIDADE SEXUAL,12,3,16,31,2019-12-01
578,HOMICÍDIO DOLOSO (exclui FEMINICÍDIO),7,4,7,18,2019-11-01
579,FEMINICÍDIO,2,3,12,17,2019-11-01
580,HOMICÍDIO DOLOSO - TOTAL,9,7,19,35,2019-11-01
581,HOMICÍDIO CULPOSO,0,0,0,0,2019-11-01
582,TENTATIVA DE HOMICÍDIO,3,12,20,35,2019-11-01
583,LESÃO CORPORAL DOLOSA,1016,828,2837,4681,2019-11-01
584,MAUS TRATOS,2,5,17,24,2019-11-01
585,CALÚNIA - DIFAMAÇÃO - INJÚRIA,236,156,614,1006,2019-11-01
586,CONSTRANGIMENTO ILEGAL,0,1,4,5,2019-11-01
587,AMEAÇA,1006,868,3512,5386,2019-11-01
588,INVASÃO DE DOMICÍLIO,7,2,31,40,2019-11-01
589,DANO,13,9,66,88,2019-11-01
590,ESTUPRO CONSUMADO,65,46,155,266,2019-11-01
591,ESTUPRO TENTADO,18,11,35,64,2019-11-01
592,ESTUPRO DE VULNERÁVEL CONSUMADO,164,159,457,780,2019-11-01
593,ESTUPRO DE VULNERÁVEL TENTADO,9,5,14,28,2019-11-01
594,OUTROS C/C/ DIGNIDADE SEXUAL,15,6,20,41,2019-11-01
595,HOMICÍDIO DOLOSO (exclui FEMINICÍDIO),6,6,18,30,2019-10-01
596,FEMINICÍDIO,5,1,12,18,2019-10-01
597,HOMICÍDIO DOLOSO - TOTAL,11,7,30,48,2019-10-01
598,HOMICÍDIO CULPOSO,0,0,0,0,2019-10-01
599,TENTATIVA DE HOMICÍDIO,6,2,31,39,2019-10-01
600,LESÃO CORPORAL DOLOSA,904,886,3123,4913,2019-10-01
601,MAUS TRATOS,5,5,31,41,2019-10-01
602,CALÚNIA - DIFAMAÇÃO - INJÚRIA,284,186,690,1160,2019-10-01
603,CONSTRANGIMENTO ILEGAL,0,0,7,7,2019-10-01
604,AMEAÇA,859,895,4045,5799,2019-10-01
605,INVASÃO DE DOMICÍLIO,1,5,20,26,2019-10-01
606,DANO,8,18,57,83,2019-10-01
607,ESTUPRO CONSUMADO,81,65,177,323,2019-10-01
608,ESTUPRO TENTADO,17,8,28,53,2019-10-01
609,ESTUPRO DE VULNERÁVEL CONSUMADO,201,193,529,923,2019-10-01
610,ESTUPRO DE VULNERÁVEL TENTADO,10,3,19,32,2019-10-01
611,OUTROS C/C/ DIGNIDADE SEXUAL,11,3,16,30,2019-10-01
612,HOMICÍDIO DOLOSO (exclui FEMINICÍDIO),2,3,8,13,2019-09-01
613,FEMINICÍDIO,6,4,9,19,2019-09-01
614,HOMICÍDIO DOLOSO - TOTAL,8,7,17,32,2019-09-01
615,HOMICÍDIO CULPOSO,0,0,0,0,2019-09-01
616,TENTATIVA DE HOMICÍDIO,8,3,29,40,2019-09-01
617,LESÃO CORPORAL DOLOSA,933,885,2779,4597,2019-09-01
618,MAUS TRATOS,0,2,21,23,2019-09-01
619,CALÚNIA - DIFAMAÇÃO - INJÚRIA,209,175,578,962,2019-09-01
620,CONSTRANGIMENTO ILEGAL,123,0,1,124,2019-09-01
621,AMEAÇA,738,937,3572,5247,2019-09-01
622,INVASÃO DE DOMICÍLIO,1,5,23,29,2019-09-01
623,DANO,10,16,50,76,2019-09-01
624,ESTUPRO CONSUMADO,77,62,174,313,2019-09-01
625,ESTUPRO TENTADO,20,11,34,65,2019-09-01
626,ESTUPRO DE VULNERÁVEL CONSUMADO,159,151,520,830,2019-09-01
627,ESTUPRO DE VULNERÁVEL TENTADO,3,7,14,24,2019-09-01
628,OUTROS C/C/ DIGNIDADE SEXUAL,6,2,7,15,2019-09-01
629,HOMICÍDIO DOLOSO (exclui FEMINICÍDIO),1,4,22,27,2019-08-01
630,FEMINICÍDIO,5,1,7,13,2019-08-01
631,HOMICÍDIO DOLOSO - TOTAL,6,5,29,40,2019-08-01
632,HOMICÍDIO CULPOSO,0,0,6,6,2019-08-01
633,TENTATIVA DE HOMICÍDIO,3,5,19,27,2019-08-01
634,LESÃO CORPORAL DOLOSA,790,768,2696,4254,2019-08-01
635,MAUS TRATOS,1,8,20,29,2019-08-01
636,CALÚNIA - DIFAMAÇÃO - INJÚRIA,243,194,570,1007,2019-08-01
637,CONSTRANGIMENTO ILEGAL,0,0,5,5,2019-08-01
638,AMEAÇA,845,935,3518,5298,2019-08-01
639,INVASÃO DE DOMICÍLIO,7,8,18,33,2019-08-01
640,DANO,9,11,65,85,2019-08-01
641,ESTUPRO CONSUMADO,52,48,148,248,2019-08-01
642,ESTUPRO TENTADO,6,11,36,53,2019-08-01
643,ESTUPRO DE VULNERÁVEL CONSUMADO,137,178,426,741,2019-08-01
644,ESTUPRO DE VULNERÁVEL TENTADO,0,6,12,18,2019-08-01
645,OUTROS C/C/ DIGNIDADE SEXUAL,11,3,16,30,2019-08-01
646,HOMICÍDIO DOLOSO (exclui FEMINICÍDIO),4,4,5,13,2019-07-01
647,FEMINICÍDIO,3,1,1,5,2019-07-01
648,HOMICÍDIO DOLOSO - TOTAL,7,5,6,18,2019-07-01
649,HOMICÍDIO CULPOSO,0,0,0,0,2019-07-01
650,TENTATIVA DE HOMICÍDIO,7,6,23,36,2019-07-01
651,LESÃO CORPORAL DOLOSA,930,742,2531,4203,2019-07-01
652,MAUS TRATOS,1,0,24,25,2019-07-01
653,CALÚNIA - DIFAMAÇÃO - INJÚRIA,211,164,635,1010,2019-07-01
654,CONSTRANGIMENTO ILEGAL,0,0,3,3,2019-07-01
655,AMEAÇA,924,788,3396,5108,2019-07-01
656,INVASÃO DE DOMICÍLIO,0,7,15,22,2019-07-01
657,DANO,11,9,58,78,2019-07-01
658,ESTUPRO CONSUMADO,43,49,141,233,2019-07-01
659,ESTUPRO TENTADO,12,18,37,67,2019-07-01
660,ESTUPRO DE VULNERÁVEL CONSUMADO,127,128,312,567,2019-07-01
661,ESTUPRO DE VULNERÁVEL TENTADO,3,4,16,23,2019-07-01
662,OUTROS C/C/ DIGNIDADE SEXUAL,5,7,18,30,2019-07-01
663,HOMICÍDIO DOLOSO (exclui FEMINICÍDIO),4,6,14,24,2019-06-01
664,FEMINICÍDIO,2,2,7,11,2019-06-01
665,HOMICÍDIO DOLOSO - TOTAL,6,8,21,35,2019-06-01
666,HOMICÍDIO CULPOSO,0,0,0,0,2019-06-01
667,TENTATIVA DE HOMICÍDIO,5,8,21,34,2019-06-01
668,LESÃO CORPORAL DOLOSA,920,687,2325,3932,2019-06-01
669,MAUS TRATOS,2,5,22,29,2019-06-01
670,CALÚNIA - DIFAMAÇÃO - INJÚRIA,192,135,548,875,2019-06-01
671,CONSTRANGIMENTO ILEGAL,0,0,1,1,2019-06-01
672,AMEAÇA,890,687,3043,4620,2019-06-01
673,INVASÃO DE DOMICÍLIO,0,30,21,51,2019-06-01
674,DANO,11,17,43,71,2019-06-01
675,ESTUPRO CONSUMADO,53,34,109,196,2019-06-01
676,ESTUPRO TENTADO,12,6,27,45,2019-06-01
677,ESTUPRO DE VULNERÁVEL CONSUMADO,97,117,341,555,2019-06-01
678,ESTUPRO DE VULNERÁVEL TENTADO,0,7,21,28,2019-06-01
679,OUTROS C/C/ DIGNIDADE SEXUAL,5,9,8,22,2019-06-01
680,HOMICÍDIO DOLOSO (exclui FEMINICÍDIO),1,7,8,16,2019-05-01
681,FEMINICÍDIO,6,3,10,19,2019-05-01
682,HOMICÍDIO DOLOSO - TOTAL,7,10,18,35,2019-05-01
683,HOMICÍDIO CULPOSO,0,0,0,0,2019-05-01
684,TENTATIVA DE HOMICÍDIO,4,5,15,24,2019-05-01
685,LESÃO CORPORAL DOLOSA,898,923,2618,4439,2019-05-01
686,MAUS TRATOS,2,15,18,35,2019-05-01
687,CALÚNIA - DIFAMAÇÃO - INJÚRIA,175,189,599,963,2019-05-01
688,CONSTRANGIMENTO ILEGAL,1,0,3,4,2019-05-01
689,AMEAÇA,985,1012,3777,5774,2019-05-01
690,INVASÃO DE DOMICÍLIO,2,4,10,16,2019-05-01
691,DANO,12,12,41,65,2019-05-01
692,ESTUPRO CONSUMADO,53,59,132,244,2019-05-01
693,ESTUPRO TENTADO,7,16,37,60,2019-05-01
694,ESTUPRO DE VULNERÁVEL CONSUMADO,138,159,473,770,2019-05-01
695,ESTUPRO DE VULNERÁVEL TENTADO,2,4,24,30,2019-05-01
696,OUTROS C/C/ DIGNIDADE SEXUAL,3,2,17,22,2019-05-01
697,HOMICÍDIO DOLOSO (exclui FEMINICÍDIO),2,3,22,27,2019-04-01
698,FEMINICÍDIO,4,4,8,16,2019-04-01
699,HOMICÍDIO DOLOSO - TOTAL,6,7,29,42,2019-04-01
700,HOMICÍDIO CULPOSO,0,0,0,0,2019-04-01
701,TENTATIVA DE HOMICÍDIO,5,3,25,33,2019-04-01
702,LESÃO CORPORAL DOLOSA,1052,976,2909,4937,2019-04-01
703,MAUS TRATOS,8,6,22,36,2019-04-01
704,CALÚNIA - DIFAMAÇÃO - INJÚRIA,243,205,665,1113,2019-04-01
705,CONSTRANGIMENTO ILEGAL,0,1,3,4,2019-04-01
706,AMEAÇA,1003,1040,3879,5922,2019-04-01
707,INVASÃO DE DOMICÍLIO,3,6,25,34,2019-04-01
708,DANO,8,6,54,68,2019-04-01
709,ESTUPRO CONSUMADO,54,58,148,260,2019-04-01
710,ESTUPRO TENTADO,11,18,32,61,2019-04-01
711,ESTUPRO DE VULNERÁVEL CONSUMADO,163,157,397,717,2019-04-01
712,ESTUPRO DE VULNERÁVEL TENTADO,5,4,14,23,2019-04-01
713,OUTROS C/C/ DIGNIDADE SEXUAL,9,3,10,22,2019-04-01
714,HOMICÍDIO DOLOSO (exclui FEMINICÍDIO),11,4,10,25,2019-03-01
715,FEMINICÍDIO,1,6,6,13,2019-03-01
716,HOMICÍDIO DOLOSO - TOTAL,12,10,16,38,2019-03-01
717,HOMICÍDIO CULPOSO,0,0,0,0,2019-03-01
718,TENTATIVA DE HOMICÍDIO,6,6,21,33,2019-03-01
719,LESÃO CORPORAL DOLOSA,1079,846,2828,4753,2019-03-01
720,MAUS TRATOS,3,4,23,30,2019-03-01
721,CALÚNIA - DIFAMAÇÃO - INJÚRIA,225,187,619,1031,2019-03-01
722,CONSTRANGIMENTO ILEGAL,8,2,4,14,2019-03-01
723,AMEAÇA,1037,865,3651,5553,2019-03-01
724,INVASÃO DE DOMICÍLIO,3,8,35,46,2019-03-01
725,DANO,6,13,57,76,2019-03-01
726,ESTUPRO CONSUMADO,74,53,154,281,2019-03-01
727,ESTUPRO TENTADO,20,9,49,78,2019-03-01
728,ESTUPRO DE VULNERÁVEL CONSUMADO,143,154,391,688,2019-03-01
729,ESTUPRO DE VULNERÁVEL TENTADO,3,6,16,25,2019-03-01
730,OUTROS C/C/ DIGNIDADE SEXUAL,7,4,25,36,2019-03-01
731,HOMICÍDIO DOLOSO (exclui FEMINICÍDIO),2,4,9,15,2019-02-01
732,FEMINICÍDIO,2,4,6,12,2019-02-01
733,HOMICÍDIO DOLOSO - TOTAL,4,8,15,27,2019-02-01
734,HOMICÍDIO CULPOSO,0,0,1,1,2019-02-01
735,TENTATIVA DE HOMICÍDIO,4,7,20,31,2019-02-01
736,LESÃO CORPORAL DOLOSA,823,793,2647,4263,2019-02-01
737,MAUS TRATOS,4,1,20,25,2019-02-01
738,CALÚNIA - DIFAMAÇÃO - INJÚRIA,217,187,577,981,2019-02-01
739,CONSTRANGIMENTO ILEGAL,1,0,3,4,2019-02-01
740,AMEAÇA,987,951,3443,5381,2019-02-01
741,INVASÃO DE DOMICÍLIO,0,11,24,35,2019-02-01
742,DANO,10,11,58,79,2019-02-01
743,ESTUPRO CONSUMADO,62,38,146,246,2019-02-01
744,ESTUPRO TENTADO,17,11,28,56,2019-02-01
745,ESTUPRO DE VULNERÁVEL CONSUMADO,113,145,382,640,2019-02-01
746,ESTUPRO DE VULNERÁVEL TENTADO,5,3,8,16,2019-02-01
747,OUTROS C/C/ DIGNIDADE SEXUAL,8,3,10,21,2019-02-01
748,HOMICÍDIO DOLOSO (exclui FEMINICÍDIO),6,6,7,19,2019-01-01
749,FEMINICÍDIO,2,2,10,14,2019-01-01
750,HOMICÍDIO DOLOSO - TOTAL,8,8,17,33,2019-01-01
751,HOMICÍDIO CULPOSO,0,0,0,0,2019-01-01
752,TENTATIVA DE HOMICÍDIO,5,5,30,40,2019-01-01
753,LESÃO CORPORAL DOLOSA,996,937,3155,5088,2019-01-01
754,MAUS TRATOS,3,7,21,31,2019-01-01
755,CALÚNIA - DIFAMAÇÃO - INJÚRIA,224,211,604,1039,2019-01-01
756,CONSTRANGIMENTO ILEGAL,22,0,3,25,2019-01-01
757,AMEAÇA,1077,1028,4042,6147,2019-01-01
758,INVASÃO DE DOMICÍLIO,0,3,25,28,2019-01-01
759,DANO,6,14,70,90,2019-01-01
760,ESTUPRO CONSUMADO,57,43,157,257,2019-01-01
761,ESTUPRO TENTADO,20,9,41,70,2019-01-01
762,ESTUPRO DE VULNERÁVEL CONSUMADO,145,157,451,753,2019-01-01
763,ESTUPRO DE VULNERÁVEL TENTADO,5,13,17,35,2019-01-01
764,OUTROS C/C/ DIGNIDADE SEXUAL,11,5,8,24,2019-01-01
765,HOMICÍDIO DOLOSO (exclui FEMINICÍDIO),8,4,21,33,2018-12-01
766,FEMINICÍDIO,3,4,8,15,2018-12-01
767,HOMICÍDIO DOLOSO - TOTAL,11,8,29,48,2018-12-01
768,HOMICÍDIO CULPOSO,0,0,0,0,2018-12-01
769,TENTATIVA DE HOMICÍDIO,2,4,27,33,2018-12-01
770,LESÃO CORPORAL DOLOSA,774,724,2842,4340,2018-12-01
771,MAUS TRATOS,3,7,20,30,2018-12-01
772,CALÚNIA - DIFAMAÇÃO - INJÚRIA,149,159,526,834,2018-12-01
773,CONSTRANGIMENTO ILEGAL,0,0,6,6,2018-12-01
774,AMEAÇA,674,684,2953,4311,2018-12-01
775,INVASÃO DE DOMICÍLIO,2,2,24,28,2018-12-01
776,DANO,9,8,69,86,2018-12-01
777,ESTUPRO CONSUMADO,47,45,152,244,2018-12-01
778,ESTUPRO TENTADO,8,10,25,43,2018-12-01
779,ESTUPRO DE VULNERÁVEL CONSUMADO,135,134,353,622,2018-12-01
780,ESTUPRO DE VULNERÁVEL TENTADO,3,4,16,23,2018-12-01
781,OUTROS C/C/ DIGNIDADE SEXUAL,6,3,15,24,2018-12-01
782,HOMICÍDIO DOLOSO (exclui FEMINICÍDIO),6,5,14,25,2018-11-01
783,FEMINICÍDIO,1,1,7,9,2018-11-01
784,HOMICÍDIO DOLOSO - TOTAL,7,6,21,34,2018-11-01
785,HOMICÍDIO CULPOSO,0,0,0,0,2018-11-01
786,TENTATIVA DE HOMICÍDIO,2,7,20,29,2018-11-01
787,LESÃO CORPORAL DOLOSA,750,741,2541,4032,2018-11-01
788,MAUS TRATOS,0,4,27,31,2018-11-01
789,CALÚNIA - DIFAMAÇÃO - INJÚRIA,171,174,553,898,2018-11-01
790,CONSTRANGIMENTO ILEGAL,1,0,8,9,2018-11-01
791,AMEAÇA,701,827,3224,4752,2018-11-01
792,INVASÃO DE DOMICÍLIO,1,5,20,26,2018-11-01
793,DANO,4,15,58,77,2018-11-01
794,ESTUPRO CONSUMADO,54,47,132,233,2018-11-01
795,ESTUPRO TENTADO,12,15,24,51,2018-11-01
796,ESTUPRO DE VULNERÁVEL CONSUMADO,132,147,343,622,2018-11-01
797,ESTUPRO DE VULNERÁVEL TENTADO,4,3,18,25,2018-11-01
798,OUTROS C/C/ DIGNIDADE SEXUAL,7,4,10,21,2018-11-01
799,HOMICÍDIO DOLOSO (exclui FEMINICÍDIO),1,7,12,20,2018-10-01
800,FEMINICÍDIO,5,1,11,17,2018-10-01
801,HOMICÍDIO DOLOSO - TOTAL,6,8,23,37,2018-10-01
802,HOMICÍDIO CULPOSO,1,0,0,1,2018-10-01
803,TENTATIVA DE HOMICÍDIO,1,5,22,28,2018-10-01
804,LESÃO CORPORAL DOLOSA,766,821,2863,4450,2018-10-01
805,MAUS TRATOS,3,7,12,22,2018-10-01
806,CALÚNIA - DIFAMAÇÃO - INJÚRIA,213,207,614,1034,2018-10-01
807,CONSTRANGIMENTO ILEGAL,3,0,21,24,2018-10-01
808,AMEAÇA,903,913,3475,5291,2018-10-01
809,INVASÃO DE DOMICÍLIO,2,4,33,39,2018-10-01
810,DANO,7,13,61,81,2018-10-01
811,ESTUPRO CONSUMADO,53,61,167,281,2018-10-01
812,ESTUPRO TENTADO,16,16,39,71,2018-10-01
813,ESTUPRO DE VULNERÁVEL CONSUMADO,140,178,472,790,2018-10-01
814,ESTUPRO DE VULNERÁVEL TENTADO,8,3,14,25,2018-10-01
815,OUTROS C/C/ DIGNIDADE SEXUAL,5,7,9,21,2018-10-01
816,HOMICÍDIO DOLOSO (exclui FEMINICÍDIO),3,5,7,15,2018-09-01
817,FEMINICÍDIO,4,1,6,11,2018-09-01
818,HOMICÍDIO DOLOSO - TOTAL,7,6,13,26,2018-09-01
819,HOMICÍDIO CULPOSO,0,0,0,0,2018-09-01
820,TENTATIVA DE HOMICÍDIO,1,8,21,30,2018-09-01
821,LESÃO CORPORAL DOLOSA,749,695,2475,3919,2018-09-01
822,MAUS TRATOS,3,5,15,23,2018-09-01
823,CALÚNIA - DIFAMAÇÃO - INJÚRIA,193,186,551,930,2018-09-01
824,CONSTRANGIMENTO ILEGAL,0,1,17,18,2018-09-01
825,AMEAÇA,764,739,3037,4540,2018-09-01
826,INVASÃO DE DOMICÍLIO,2,4,22,28,2018-09-01
827,DANO,8,10,51,69,2018-09-01
828,ESTUPRO CONSUMADO,61,63,133,257,2018-09-01
829,ESTUPRO TENTADO,20,19,36,75,2018-09-01
830,ESTUPRO DE VULNERÁVEL CONSUMADO,148,158,353,659,2018-09-01
831,ESTUPRO DE VULNERÁVEL TENTADO,2,6,15,23,2018-09-01
832,OUTROS C/C/ DIGNIDADE SEXUAL,1,1,3,5,2018-09-01
833,HOMICÍDIO DOLOSO (exclui FEMINICÍDIO),8,3,12,23,2018-08-01
834,FEMINICÍDIO,2,2,7,11,2018-08-01
835,HOMICÍDIO DOLOSO - TOTAL,10,5,19,34,2018-08-01
836,HOMICÍDIO CULPOSO,1,0,0,1,2018-08-01
837,TENTATIVA DE HOMICÍDIO,4,3,16,23,2018-08-01
838,LESÃO CORPORAL DOLOSA,715,741,2455,3911,2018-08-01
839,MAUS TRATOS,2,9,38,49,2018-08-01
840,CALÚNIA - DIFAMAÇÃO - INJÚRIA,196,183,621,1000,2018-08-01
841,CONSTRANGIMENTO ILEGAL,0,2,7,9,2018-08-01
842,AMEAÇA,881,1007,3248,5136,2018-08-01
843,INVASÃO DE DOMICÍLIO,1,3,21,25,2018-08-01
844,DANO,9,16,47,72,2018-08-01
845,ESTUPRO CONSUMADO,62,52,166,280,2018-08-01
846,ESTUPRO TENTADO,18,13,42,73,2018-08-01
847,ESTUPRO DE VULNERÁVEL CONSUMADO,134,168,401,703,2018-08-01
848,ESTUPRO DE VULNERÁVEL TENTADO,1,10,20,31,2018-08-01
849,OUTROS C/C/ DIGNIDADE SEXUAL,2,1,0,3,2018-08-01
850,HOMICÍDIO DOLOSO (exclui FEMINICÍDIO),4,4,22,30,2018-07-01
851,FEMINICÍDIO,3,5,8,16,2018-07-01
852,HOMICÍDIO DOLOSO - TOTAL,7,9,30,46,2018-07-01
853,HOMICÍDIO CULPOSO,1,0,0,1,2018-07-01
854,TENTATIVA DE HOMICÍDIO,4,5,15,24,2018-07-01
855,LESÃO CORPORAL DOLOSA,712,774,2433,3919,2018-07-01
856,MAUS TRATOS,4,3,16,23,2018-07-01
857,CALÚNIA - DIFAMAÇÃO - INJÚRIA,196,181,523,900,2018-07-01
858,CONSTRANGIMENTO ILEGAL,2,1,4,7,2018-07-01
859,AMEAÇA,689,719,2894,4302,2018-07-01
860,INVASÃO DE DOMICÍLIO,0,5,14,19,2018-07-01
861,DANO,7,9,59,75,2018-07-01
862,ESTUPRO CONSUMADO,60,48,134,242,2018-07-01
863,ESTUPRO TENTADO,6,14,29,49,2018-07-01
864,ESTUPRO DE VULNERÁVEL CONSUMADO,112,137,315,564,2018-07-01
865,ESTUPRO DE VULNERÁVEL TENTADO,4,5,19,28,2018-07-01
866,OUTROS C/C/ DIGNIDADE SEXUAL,1,2,1,4,2018-07-01
867,HOMICÍDIO DOLOSO (exclui FEMINICÍDIO),6,1,16,23,2018-06-01
868,FEMINICÍDIO,1,1,4,6,2018-06-01
869,HOMICÍDIO DOLOSO - TOTAL,7,2,20,29,2018-06-01
870,HOMICÍDIO CULPOSO,0,0,0,0,2018-06-01
871,TENTATIVA DE HOMICÍDIO,1,3,22,26,2018-06-01
872,LESÃO CORPORAL DOLOSA,813,712,2386,3911,2018-06-01
873,MAUS TRATOS,2,6,28,36,2018-06-01
874,CALÚNIA - DIFAMAÇÃO - INJÚRIA,196,151,517,864,2018-06-01
875,CONSTRANGIMENTO ILEGAL,1,1,2,4,2018-06-01
876,AMEAÇA,745,680,2795,4220,2018-06-01
877,INVASÃO DE DOMICÍLIO,5,1,17,23,2018-06-01
878,DANO,3,13,66,82,2018-06-01
879,ESTUPRO CONSUMADO,61,42,151,254,2018-06-01
880,ESTUPRO TENTADO,10,10,35,55,2018-06-01
881,ESTUPRO DE VULNERÁVEL CONSUMADO,110,136,359,605,2018-06-01
882,ESTUPRO DE VULNERÁVEL TENTADO,7,4,13,24,2018-06-01
883,OUTROS C/C/ DIGNIDADE SEXUAL,2,2,5,9,2018-06-01
884,HOMICÍDIO DOLOSO (exclui FEMINICÍDIO),3,4,13,20,2018-05-01
885,FEMINICÍDIO,4,6,6,16,2018-05-01
886,HOMICÍDIO DOLOSO - TOTAL,7,10,19,36,2018-05-01
887,HOMICÍDIO CULPOSO,0,0,0,0,2018-05-01
888,TENTATIVA DE HOMICÍDIO,7,7,14,28,2018-05-01
889,LESÃO CORPORAL DOLOSA,794,737,2565,4096,2018-05-01
890,MAUS TRATOS,5,6,26,37,2018-05-01
891,CALÚNIA - DIFAMAÇÃO - INJÚRIA,229,185,599,1013,2018-05-01
892,CONSTRANGIMENTO ILEGAL,5,0,12,17,2018-05-01
893,AMEAÇA,735,773,3272,4780,2018-05-01
894,INVASÃO DE DOMICÍLIO,2,2,26,30,2018-05-01
895,DANO,15,7,53,75,2018-05-01
896,ESTUPRO CONSUMADO,64,59,155,278,2018-05-01
897,ESTUPRO TENTADO,23,12,39,74,2018-05-01
898,ESTUPRO DE VULNERÁVEL CONSUMADO,158,132,399,689,2018-05-01
899,ESTUPRO DE VULNERÁVEL TENTADO,6,5,13,24,2018-05-01
900,OUTROS C/C/ DIGNIDADE SEXUAL,4,0,2,6,2018-05-01
901,HOMICÍDIO DOLOSO (exclui FEMINICÍDIO),9,8,21,38,2018-04-01
902,FEMINICÍDIO,2,3,9,14,2018-04-01
903,HOMICÍDIO DOLOSO - TOTAL,11,11,30,52,2018-04-01
904,HOMICÍDIO CULPOSO,0,0,0,0,2018-04-01
905,TENTATIVA DE HOMICÍDIO,1,3,6,10,2018-04-01
906,LESÃO CORPORAL DOLOSA,730,736,2648,4114,2018-04-01
907,MAUS TRATOS,1,5,22,28,2018-04-01
908,CALÚNIA - DIFAMAÇÃO - INJÚRIA,273,214,603,1090,2018-04-01
909,CONSTRANGIMENTO ILEGAL,1,0,7,8,2018-04-01
910,AMEAÇA,745,843,3227,4815,2018-04-01
911,INVASÃO DE DOMICÍLIO,1,7,24,32,2018-04-01
912,DANO,10,8,58,76,2018-04-01
913,ESTUPRO CONSUMADO,72,42,152,266,2018-04-01
914,ESTUPRO TENTADO,17,12,41,70,2018-04-01
915,ESTUPRO DE VULNERÁVEL CONSUMADO,128,141,330,599,2018-04-01
916,ESTUPRO DE VULNERÁVEL TENTADO,5,9,11,25,2018-04-01
917,OUTROS C/C/ DIGNIDADE SEXUAL,1,0,4,5,2018-04-01
918,HOMICÍDIO DOLOSO (exclui FEMINICÍDIO),5,5,18,28,2018-03-01
919,FEMINICÍDIO,0,5,3,8,2018-03-01
920,HOMICÍDIO DOLOSO - TOTAL,5,10,21,36,2018-03-01
921,HOMICÍDIO CULPOSO,0,0,0,0,2018-03-01
922,TENTATIVA DE HOMICÍDIO,5,6,23,34,2018-03-01
923,LESÃO CORPORAL DOLOSA,1014,861,3098,4973,2018-03-01
924,MAUS TRATOS,2,2,24,28,2018-03-01
925,CALÚNIA - DIFAMAÇÃO - INJÚRIA,239,217,695,1151,2018-03-01
926,CONSTRANGIMENTO ILEGAL,0,0,1,1,2018-03-01
927,AMEAÇA,871,967,3751,5589,2018-03-01
928,INVASÃO DE DOMICÍLIO,0,6,24,30,2018-03-01
929,DANO,9,9,61,79,2018-03-01
930,ESTUPRO CONSUMADO,64,58,185,307,2018-03-01
931,ESTUPRO TENTADO,19,18,51,88,2018-03-01
932,ESTUPRO DE VULNERÁVEL CONSUMADO,150,164,479,793,2018-03-01
933,ESTUPRO DE VULNERÁVEL TENTADO,7,6,19,32,2018-03-01
934,OUTROS C/C/ DIGNIDADE SEXUAL,10,1,2,13,2018-03-01
935,HOMICÍDIO DOLOSO (exclui FEMINICÍDIO),8,5,18,31,2018-02-01
936,FEMINICÍDIO,4,0,4,8,2018-02-01
937,HOMICÍDIO DOLOSO - TOTAL,12,5,22,39,2018-02-01
938,HOMICÍDIO CULPOSO,0,0,0,0,2018-02-01
939,TENTATIVA DE HOMICÍDIO,1,3,13,17,2018-02-01
940,LESÃO CORPORAL DOLOSA,845,716,2662,4223,2018-02-01
941,MAUS TRATOS,1,2,15,18,2018-02-01
942,CALÚNIA - DIFAMAÇÃO - INJÚRIA,259,190,531,980,2018-02-01
943,CONSTRANGIMENTO ILEGAL,0,0,2,2,2018-02-01
944,AMEAÇA,669,754,3051,4474,2018-02-01
945,INVASÃO DE DOMICÍLIO,2,4,18,24,2018-02-01
946,DANO,9,12,42,63,2018-02-01
947,ESTUPRO CONSUMADO,69,54,180,303,2018-02-01
948,ESTUPRO TENTADO,14,17,39,70,2018-02-01
949,ESTUPRO DE VULNERÁVEL CONSUMADO,132,124,379,635,2018-02-01
950,ESTUPRO DE VULNERÁVEL TENTADO,6,11,25,42,2018-02-01
951,OUTROS C/C/ DIGNIDADE SEXUAL,0,0,2,2,2018-02-01
952,HOMICÍDIO DOLOSO (exclui FEMINICÍDIO),5,12,22,39,2018-01-01
953,FEMINICÍDIO,0,0,5,5,2018-01-01
954,HOMICÍDIO DOLOSO - TOTAL,5,12,27,44,2018-01-01
955,HOMICÍDIO CULPOSO,0,0,0,0,2018-01-01
956,TENTATIVA DE HOMICÍDIO,4,1,16,21,2018-01-01
957,LESÃO CORPORAL DOLOSA,926,883,2991,4800,2018-01-01
958,MAUS TRATOS,2,1,28,31,2018-01-01
959,CALÚNIA - DIFAMAÇÃO - INJÚRIA,203,204,642,1049,2018-01-01
960,CONSTRANGIMENTO ILEGAL,2,0,5,7,2018-01-01
961,AMEAÇA,773,904,3409,5086,2018-01-01
962,INVASÃO DE DOMICÍLIO,2,7,21,30,2018-01-01
963,DANO,11,11,40,62,2018-01-01
964,ESTUPRO CONSUMADO,74,66,141,281,2018-01-01
965,ESTUPRO TENTADO,14,8,50,72,2018-01-01
966,ESTUPRO DE VULNERÁVEL CONSUMADO,125,138,404,667,2018-01-01
967,ESTUPRO DE VULNERÁVEL TENTADO,7,6,12,25,2018-01-01
968,OUTROS C/C/ DIGNIDADE SEXUAL,1,0,3,4,2018-01-01
969,HOMICÍDIO DOLOSO (exclui FEMINICÍDIO),1,2,3,6,2017-12-01
970,HOMICÍDIO CULPOSO,0,0,0,0,2017-12-01
971,TENTATIVA DE HOMICÍDIO,1,21,2,24,2017-12-01
972,LESÃO CORPORAL DOLOSA,902,2135,802,3839,2017-12-01
973,MAUS TRATOS,1,25,2,28,2017-12-01
974,CALÚNIA - DIFAMAÇÃO - INJÚRIA,153,546,157,856,2017-12-01
975,CONSTRANGIMENTO ILEGAL,0,18,5,23,2017-12-01
976,AMEAÇA,650,3128,754,4532,2017-12-01
977,INVASÃO DE DOMICÍLIO,14,14,4,32,2017-12-01
978,DANO,4,57,3,64,2017-12-01
979,ESTUPRO CONSUMADO,17,30,8,55,2017-12-01
980,ESTUPRO TENTADO,1,6,0,7,2017-12-01
981,ESTUPRO DE VULNERÁVEL CONSUMADO,8,24,6,38,2017-12-01
982,OUTROS C/C/ DIGNIDADE SEXUAL,2,1,0,3,2017-12-01
983,HOMICÍDIO DOLOSO (exclui FEMINICÍDIO),1,1,5,7,2017-11-01
984,HOMICÍDIO CULPOSO,0,0,1,1,2017-11-01
985,TENTATIVA DE HOMICÍDIO,5,1,19,25,2017-11-01
986,LESÃO CORPORAL DOLOSA,831,727,2798,4356,2017-11-01
987,MAUS TRATOS,5,3,23,31,2017-11-01
988,CALÚNIA - DIFAMAÇÃO - INJÚRIA,199,186,573,958,2017-11-01
989,CONSTRANGIMENTO ILEGAL,1,0,16,17,2017-11-01
990,AMEAÇA,687,776,3116,4579,2017-11-01
991,INVASÃO DE DOMICÍLIO,0,3,21,24,2017-11-01
992,DANO,5,5,54,64,2017-11-01
993,ESTUPRO CONSUMADO,20,7,23,50,2017-11-01
994,ESTUPRO TENTADO,2,0,4,6,2017-11-01
995,ESTUPRO DE VULNERÁVEL CONSUMADO,9,8,37,54,2017-11-01
996,OUTROS C/C/ DIGNIDADE SEXUAL,1,1,1,3,2017-11-01
997,HOMICÍDIO DOLOSO (exclui FEMINICÍDIO),0,0,6,6,2017-10-01
998,HOMICÍDIO CULPOSO,0,0,0,0,2017-10-01
999,TENTATIVA DE HOMICÍDIO,1,4,24,29,2017-10-01
1000,LESÃO CORPORAL DOLOSA,764,817,2987,4568,2017-10-01
1001,MAUS TRATOS,3,4,26,33,2017-10-01
1002,CALÚNIA - DIFAMAÇÃO - INJÚRIA,288,183,676,1147,2017-10-01
1003,CONSTRANGIMENTO ILEGAL,0,20,20,40,2017-10-01
1004,AMEAÇA,661,950,3570,5181,2017-10-01
1005,INVASÃO DE DOMICÍLIO,5,10,13,28,2017-10-01
1006,DANO,7,6,59,72,2017-10-01
1007,ESTUPRO CONSUMADO,10,9,27,46,2017-10-01
1008,ESTUPRO TENTADO,0,0,4,4,2017-10-01
1009,ESTUPRO DE VULNERÁVEL CONSUMADO,5,8,38,51,2017-10-01
1010,OUTROS C/C/ DIGNIDADE SEXUAL,0,1,1,2,2017-10-01
1011,HOMICÍDIO DOLOSO (exclui FEMINICÍDIO),0,0,3,3,2017-09-01
1012,HOMICÍDIO CULPOSO,0,0,0,0,2017-09-01
1013,TENTATIVA DE HOMICÍDIO,1,7,23,31,2017-09-01
1014,LESÃO CORPORAL DOLOSA,810,736,2625,4171,2017-09-01
1015,MAUS TRATOS,4,5,25,34,2017-09-01
1016,CALÚNIA - DIFAMAÇÃO - INJÚRIA,210,168,618,996,2017-09-01
1017,CONSTRANGIMENTO ILEGAL,4,0,4,8,2017-09-01
1018,AMEAÇA,622,796,3114,4532,2017-09-01
1019,INVASÃO DE DOMICÍLIO,1,4,11,16,2017-09-01
1020,DANO,10,4,74,88,2017-09-01
1021,ESTUPRO CONSUMADO,4,10,25,39,2017-09-01
1022,ESTUPRO TENTADO,0,0,4,4,2017-09-01
1023,ESTUPRO DE VULNERÁVEL CONSUMADO,6,13,34,53,2017-09-01
1024,OUTROS C/C/ DIGNIDADE SEXUAL,4,0,4,8,2017-09-01
1025,HOMICÍDIO DOLOSO (exclui FEMINICÍDIO),2,1,9,12,2017-08-01
1026,HOMICÍDIO CULPOSO,0,0,0,0,2017-08-01
1027,TENTATIVA DE HOMICÍDIO,0,1,18,19,2017-08-01
1028,LESÃO CORPORAL DOLOSA,922,794,2503,4219,2017-08-01
1029,MAUS TRATOS,0,1,18,19,2017-08-01
1030,CALÚNIA - DIFAMAÇÃO - INJÚRIA,265,178,632,1075,2017-08-01
1031,CONSTRANGIMENTO ILEGAL,2,1,8,11,2017-08-01
1032,AMEAÇA,612,917,3182,4711,2017-08-01
1033,INVASÃO DE DOMICÍLIO,0,0,20,20,2017-08-01
1034,DANO,11,5,48,64,2017-08-01
1035,ESTUPRO CONSUMADO,13,9,27,49,2017-08-01
1036,ESTUPRO TENTADO,0,2,4,6,2017-08-01
1037,ESTUPRO DE VULNERÁVEL CONSUMADO,5,6,25,36,2017-08-01
1038,OUTROS C/C/ DIGNIDADE SEXUAL,1,0,2,3,2017-08-01
1039,HOMICÍDIO DOLOSO (exclui FEMINICÍDIO),1,2,5,8,2017-07-01
1040,HOMICÍDIO CULPOSO,0,0,0,0,2017-07-01
1041,TENTATIVA DE HOMICÍDIO,2,1,16,19,2017-07-01
1042,LESÃO CORPORAL DOLOSA,697,693,2322,3712,2017-07-01
1043,MAUS TRATOS,1,1,11,13,2017-07-01
1044,CALÚNIA - DIFAMAÇÃO - INJÚRIA,173,179,603,955,2017-07-01
1045,CONSTRANGIMENTO ILEGAL,0,11,8,19,2017-07-01
1046,AMEAÇA,583,786,2970,4339,2017-07-01
1047,INVASÃO DE DOMICÍLIO,4,8,14,26,2017-07-01
1048,DANO,10,9,53,72,2017-07-01
1049,ESTUPRO CONSUMADO,7,11,12,30,2017-07-01
1050,ESTUPRO TENTADO,0,0,2,2,2017-07-01
1051,ESTUPRO DE VULNERÁVEL CONSUMADO,8,7,21,36,2017-07-01
1052,OUTROS C/C/ DIGNIDADE SEXUAL,2,3,3,8,2017-07-01
1053,HOMICÍDIO DOLOSO (exclui FEMINICÍDIO),0,2,2,4,2017-06-01
1054,HOMICÍDIO CULPOSO,0,0,0,0,2017-06-01
1055,TENTATIVA DE HOMICÍDIO,1,1,12,14,2017-06-01
1056,LESÃO CORPORAL DOLOSA,679,769,2467,3915,2017-06-01
1057,MAUS TRATOS,0,3,22,25,2017-06-01
1058,CALÚNIA - DIFAMAÇÃO - INJÚRIA,175,176,602,953,2017-06-01
1059,CONSTRANGIMENTO ILEGAL,13,3,5,21,2017-06-01
1060,AMEAÇA,613,832,3003,4448,2017-06-01
1061,INVASÃO DE DOMICÍLIO,3,5,10,18,2017-06-01
1062,DANO,7,2,55,64,2017-06-01
1063,ESTUPRO CONSUMADO,11,6,17,34,2017-06-01
1064,ESTUPRO TENTADO,0,0,0,0,2017-06-01
1065,ESTUPRO DE VULNERÁVEL CONSUMADO,5,3,26,34,2017-06-01
1066,OUTROS C/C/ DIGNIDADE SEXUAL,0,0,0,0,2017-06-01
1067,HOMICÍDIO DOLOSO (exclui FEMINICÍDIO),1,2,6,9,2017-05-01
1068,HOMICÍDIO CULPOSO,0,0,0,0,2017-05-01
1069,TENTATIVA DE HOMICÍDIO,5,7,18,30,2017-05-01
1070,LESÃO CORPORAL DOLOSA,622,740,2700,4062,2017-05-01
1071,MAUS TRATOS,1,5,28,34,2017-05-01
1072,CALÚNIA - DIFAMAÇÃO - INJÚRIA,286,190,658,1134,2017-05-01
1073,CONSTRANGIMENTO ILEGAL,1,2,5,8,2017-05-01
1074,AMEAÇA,614,865,3304,4783,2017-05-01
1075,INVASÃO DE DOMICÍLIO,0,11,31,42,2017-05-01
1076,DANO,8,8,48,64,2017-05-01
1077,ESTUPRO CONSUMADO,16,7,21,44,2017-05-01
1078,ESTUPRO TENTADO,1,1,3,5,2017-05-01
1079,ESTUPRO DE VULNERÁVEL CONSUMADO,11,9,26,46,2017-05-01
1080,OUTROS C/C/ DIGNIDADE SEXUAL,0,0,2,2,2017-05-01
1081,HOMICÍDIO DOLOSO (exclui FEMINICÍDIO),1,2,0,3,2017-04-01
1082,HOMICÍDIO CULPOSO,1,0,0,1,2017-04-01
1083,TENTATIVA DE HOMICÍDIO,3,5,7,15,2017-04-01
1084,LESÃO CORPORAL DOLOSA,784,828,2623,4235,2017-04-01
1085,MAUS TRATOS,2,7,18,27,2017-04-01
1086,CALÚNIA - DIFAMAÇÃO - INJÚRIA,281,192,632,1105,2017-04-01
1087,CONSTRANGIMENTO ILEGAL,1,1,4,6,2017-04-01
1088,AMEAÇA,700,809,3054,4563,2017-04-01
1089,INVASÃO DE DOMICÍLIO,1,5,13,19,2017-04-01
1090,DANO,5,6,65,76,2017-04-01
1091,ESTUPRO CONSUMADO,8,10,20,38,2017-04-01
1092,ESTUPRO TENTADO,0,0,3,3,2017-04-01
1093,ESTUPRO DE VULNERÁVEL CONSUMADO,4,5,32,41,2017-04-01
1094,OUTROS C/C/ DIGNIDADE SEXUAL,0,1,3,4,2017-04-01
1095,HOMICÍDIO DOLOSO (exclui FEMINICÍDIO),1,3,7,11,2017-03-01
1096,HOMICÍDIO CULPOSO,0,0,1,1,2017-03-01
1097,TENTATIVA DE HOMICÍDIO,7,2,18,27,2017-03-01
1098,LESÃO CORPORAL DOLOSA,825,844,3176,4845,2017-03-01
1099,MAUS TRATOS,2,2,23,27,2017-03-01
1100,CALÚNIA - DIFAMAÇÃO - INJÚRIA,343,237,768,1348,2017-03-01
1101,CONSTRANGIMENTO ILEGAL,0,4,4,8,2017-03-01
1102,AMEAÇA,859,982,3873,5714,2017-03-01
1103,INVASÃO DE DOMICÍLIO,2,5,19,26,2017-03-01
1104,DANO,8,11,48,67,2017-03-01
1105,ESTUPRO CONSUMADO,8,5,22,35,2017-03-01
1106,ESTUPRO TENTADO,0,0,2,2,2017-03-01
1107,ESTUPRO DE VULNERÁVEL CONSUMADO,9,5,24,38,2017-03-01
1108,OUTROS C/C/ DIGNIDADE SEXUAL,0,1,3,4,2017-03-01
1109,HOMICÍDIO DOLOSO (exclui FEMINICÍDIO),3,1,1,5,2017-02-01
1110,HOMICÍDIO CULPOSO,0,0,0,0,2017-02-01
1111,TENTATIVA DE HOMICÍDIO,2,6,19,27,2017-02-01
1112,LESÃO CORPORAL DOLOSA,675,806,2690,4171,2017-02-01
1113,MAUS TRATOS,3,4,17,24,2017-02-01
1114,CALÚNIA - DIFAMAÇÃO - INJÚRIA,225,155,697,1077,2017-02-01
1115,CONSTRANGIMENTO ILEGAL,2,1,4,7,2017-02-01
1116,AMEAÇA,593,851,3230,4674,2017-02-01
1117,INVASÃO DE DOMICÍLIO,0,11,21,32,2017-02-01
1118,DANO,7,10,54,71,2017-02-01
1119,ESTUPRO CONSUMADO,10,11,24,45,2017-02-01
1120,ESTUPRO TENTADO,0,1,6,7,2017-02-01
1121,ESTUPRO DE VULNERÁVEL CONSUMADO,3,2,16,21,2017-02-01
1122,OUTROS C/C/ DIGNIDADE SEXUAL,1,0,3,4,2017-02-01
1123,HOMICÍDIO DOLOSO (exclui FEMINICÍDIO),2,4,5,11,2017-01-01
1124,HOMICÍDIO CULPOSO,0,0,2,2,2017-01-01
1125,TENTATIVA DE HOMICÍDIO,6,4,12,22,2017-01-01
1126,LESÃO CORPORAL DOLOSA,753,771,3048,4572,2017-01-01
1127,MAUS TRATOS,5,3,26,34,2017-01-01
1128,CALÚNIA - DIFAMAÇÃO - INJÚRIA,261,142,743,1146,2017-01-01
1129,CONSTRANGIMENTO ILEGAL,1,0,6,7,2017-01-01
1130,AMEAÇA,844,876,3732,5452,2017-01-01
1131,INVASÃO DE DOMICÍLIO,1,4,15,20,2017-01-01
1132,DANO,9,5,65,79,2017-01-01
1133,ESTUPRO CONSUMADO,16,6,29,51,2017-01-01
1134,ESTUPRO TENTADO,1,1,4,6,2017-01-01
1135,ESTUPRO DE VULNERÁVEL CONSUMADO,7,2,13,22,2017-01-01
1136,OUTROS C/C/ DIGNIDADE SEXUAL,2,0,7,9,2017-01-01
1137,HOMICÍDIO DOLOSO (exclui FEMINICÍDIO),1,0,6,7,2016-12-01
1138,HOMICÍDIO CULPOSO,0,0,0,0,2016-12-01
1139,TENTATIVA DE HOMICÍDIO,6,6,16,28,2016-12-01
1140,LESÃO CORPORAL DOLOSA,640,831,3123,4594,2016-12-01
1141,MAUS TRATOS,3,1,19,23,2016-12-01
1142,CALÚNIA - DIFAMAÇÃO - INJÚRIA,314,187,701,1202,2016-12-01
1143,CONSTRANGIMENTO ILEGAL,0,0,55,55,2016-12-01
1144,AMEAÇA,663,717,3369,4749,2016-12-01
1145,INVASÃO DE DOMICÍLIO,3,1,19,23,2016-12-01
1146,DANO,7,15,65,87,2016-12-01
1147,ESTUPRO CONSUMADO,4,7,23,34,2016-12-01
1148,ESTUPRO TENTADO,0,3,3,6,2016-12-01
1149,ESTUPRO DE VULNERÁVEL CONSUMADO,7,6,13,26,2016-12-01
1150,OUTROS C/C/ DIGNIDADE SEXUAL,0,0,2,2,2016-12-01
1151,HOMICÍDIO DOLOSO (exclui FEMINICÍDIO),3,1,5,9,2016-11-01
1152,HOMICÍDIO CULPOSO,0,0,0,0,2016-11-01
1153,TENTATIVA DE HOMICÍDIO,3,4,16,23,2016-11-01
1154,LESÃO CORPORAL DOLOSA,859,720,2998,4577,2016-11-01
1155,MAUS TRATOS,4,2,22,28,2016-11-01
1156,CALÚNIA - DIFAMAÇÃO - INJÚRIA,298,206,701,1205,2016-11-01
1157,CONSTRANGIMENTO ILEGAL,0,0,37,37,2016-11-01
1158,AMEAÇA,827,822,3161,4810,2016-11-01
1159,INVASÃO DE DOMICÍLIO,3,1,14,18,2016-11-01
1160,DANO,13,10,48,71,2016-11-01
1161,ESTUPRO CONSUMADO,6,3,20,29,2016-11-01
1162,ESTUPRO TENTADO,0,0,1,1,2016-11-01
1163,ESTUPRO DE VULNERÁVEL CONSUMADO,5,6,23,34,2016-11-01
1164,OUTROS C/C/ DIGNIDADE SEXUAL,0,1,1,2,2016-11-01
1165,HOMICÍDIO DOLOSO (exclui FEMINICÍDIO),3,1,6,10,2016-10-01
1166,HOMICÍDIO CULPOSO,0,0,0,0,2016-10-01
1167,TENTATIVA DE HOMICÍDIO,3,6,18,27,2016-10-01
1168,LESÃO CORPORAL DOLOSA,880,863,2932,4675,2016-10-01
1169,MAUS TRATOS,1,6,18,25,2016-10-01
1170,CALÚNIA - DIFAMAÇÃO - INJÚRIA,278,182,658,1118,2016-10-01
1171,CONSTRANGIMENTO ILEGAL,1,14,2,17,2016-10-01
1172,AMEAÇA,803,930,3261,4994,2016-10-01
1173,INVASÃO DE DOMICÍLIO,4,3,14,21,2016-10-01
1174,DANO,8,12,60,80,2016-10-01
1175,ESTUPRO CONSUMADO,6,2,10,18,2016-10-01
1176,ESTUPRO TENTADO,3,0,1,4,2016-10-01
1177,ESTUPRO DE VULNERÁVEL CONSUMADO,10,11,26,47,2016-10-01
1178,OUTROS C/C/ DIGNIDADE SEXUAL,0,0,0,0,2016-10-01
1179,HOMICÍDIO DOLOSO (exclui FEMINICÍDIO),1,1,7,9,2016-09-01
1180,HOMICÍDIO CULPOSO,0,0,0,0,2016-09-01
1181,TENTATIVA DE HOMICÍDIO,4,2,18,24,2016-09-01
1182,LESÃO CORPORAL DOLOSA,808,721,2595,4124,2016-09-01
1183,MAUS TRATOS,4,6,22,32,2016-09-01
1184,CALÚNIA - DIFAMAÇÃO - INJÚRIA,266,176,657,1099,2016-09-01
1185,CONSTRANGIMENTO ILEGAL,0,0,3,3,2016-09-01
1186,AMEAÇA,737,762,3369,4868,2016-09-01
1187,INVASÃO DE DOMICÍLIO,0,2,15,17,2016-09-01
1188,DANO,14,12,57,83,2016-09-01
1189,ESTUPRO CONSUMADO,14,8,12,34,2016-09-01
1190,ESTUPRO TENTADO,0,0,2,2,2016-09-01
1191,ESTUPRO DE VULNERÁVEL CONSUMADO,2,6,14,22,2016-09-01
1192,OUTROS C/C/ DIGNIDADE SEXUAL,1,1,3,5,2016-09-01
1193,HOMICÍDIO DOLOSO (exclui FEMINICÍDIO),1,1,5,7,2016-08-01
1194,HOMICÍDIO CULPOSO,1,0,0,1,2016-08-01
1195,TENTATIVA DE HOMICÍDIO,3,3,13,19,2016-08-01
1196,LESÃO CORPORAL DOLOSA,826,820,2753,4399,2016-08-01
1197,MAUS TRATOS,1,9,29,39,2016-08-01
1198,CALÚNIA - DIFAMAÇÃO - INJÚRIA,325,221,721,1267,2016-08-01
1199,CONSTRANGIMENTO ILEGAL,1,0,5,6,2016-08-01
1200,AMEAÇA,781,843,3330,4954,2016-08-01
1201,INVASÃO DE DOMICÍLIO,0,4,29,33,2016-08-01
1202,DANO,9,9,60,78,2016-08-01
1203,ESTUPRO CONSUMADO,17,14,15,46,2016-08-01
1204,ESTUPRO TENTADO,0,0,1,1,2016-08-01
1205,ESTUPRO DE VULNERÁVEL CONSUMADO,8,4,20,32,2016-08-01
1206,OUTROS C/C/ DIGNIDADE SEXUAL,1,0,2,3,2016-08-01
1207,HOMICÍDIO DOLOSO (exclui FEMINICÍDIO),2,0,4,6,2016-07-01
1208,HOMICÍDIO CULPOSO,0,0,0,0,2016-07-01
1209,TENTATIVA DE HOMICÍDIO,4,2,22,28,2016-07-01
1210,LESÃO CORPORAL DOLOSA,670,708,2334,3712,2016-07-01
1211,MAUS TRATOS,1,4,23,28,2016-07-01
1212,CALÚNIA - DIFAMAÇÃO - INJÚRIA,154,211,647,1012,2016-07-01
1213,CONSTRANGIMENTO ILEGAL,3,1,6,10,2016-07-01
1214,AMEAÇA,672,781,3120,4573,2016-07-01
1215,INVASÃO DE DOMICÍLIO,0,2,9,11,2016-07-01
1216,DANO,12,9,57,78,2016-07-01
1217,ESTUPRO CONSUMADO,12,1,23,36,2016-07-01
1218,ESTUPRO TENTADO,0,0,2,2,2016-07-01
1219,ESTUPRO DE VULNERÁVEL CONSUMADO,9,2,11,22,2016-07-01
1220,OUTROS C/C/ DIGNIDADE SEXUAL,1,0,4,5,2016-07-01
1221,HOMICÍDIO DOLOSO (exclui FEMINICÍDIO),2,0,2,4,2016-06-01
1222,HOMICÍDIO CULPOSO,0,0,0,0,2016-06-01
1223,TENTATIVA DE HOMICÍDIO,0,2,12,14,2016-06-01
1224,LESÃO CORPORAL DOLOSA,621,662,2242,3525,2016-06-01
1225,MAUS TRATOS,2,5,17,24,2016-06-01
1226,CALÚNIA - DIFAMAÇÃO - INJÚRIA,252,238,647,1137,2016-06-01
1227,CONSTRANGIMENTO ILEGAL,0,0,12,12,2016-06-01
1228,AMEAÇA,739,750,3077,4566,2016-06-01
1229,INVASÃO DE DOMICÍLIO,3,16,13,32,2016-06-01
1230,DANO,10,15,56,81,2016-06-01
1231,ESTUPRO CONSUMADO,14,10,20,44,2016-06-01
1232,ESTUPRO TENTADO,0,2,1,3,2016-06-01
1233,ESTUPRO DE VULNERÁVEL CONSUMADO,12,6,33,51,2016-06-01
1234,OUTROS C/C/ DIGNIDADE SEXUAL,1,0,2,3,2016-06-01
1235,HOMICÍDIO DOLOSO (exclui FEMINICÍDIO),1,2,3,6,2016-05-01
1236,HOMICÍDIO CULPOSO,0,0,0,0,2016-05-01
1237,TENTATIVA DE HOMICÍDIO,4,3,14,21,2016-05-01
1238,LESÃO CORPORAL DOLOSA,662,696,2486,3844,2016-05-01
1239,MAUS TRATOS,2,5,25,32,2016-05-01
1240,CALÚNIA - DIFAMAÇÃO - INJÚRIA,233,241,654,1128,2016-05-01
1241,CONSTRANGIMENTO ILEGAL,1,0,2,3,2016-05-01
1242,AMEAÇA,695,794,3105,4594,2016-05-01
1243,INVASÃO DE DOMICÍLIO,0,2,20,22,2016-05-01
1244,DANO,9,10,52,71,2016-05-01
1245,ESTUPRO CONSUMADO,5,6,13,24,2016-05-01
1246,ESTUPRO TENTADO,0,1,1,2,2016-05-01
1247,ESTUPRO DE VULNERÁVEL CONSUMADO,8,11,13,32,2016-05-01
1248,OUTROS C/C/ DIGNIDADE SEXUAL,0,0,1,1,2016-05-01
1249,HOMICÍDIO DOLOSO (exclui FEMINICÍDIO),4,0,4,8,2016-04-01
1250,HOMICÍDIO CULPOSO,0,0,1,1,2016-04-01
1251,TENTATIVA DE HOMICÍDIO,2,5,16,23,2016-04-01
1252,LESÃO CORPORAL DOLOSA,888,892,2945,4725,2016-04-01
1253,MAUS TRATOS,1,1,17,19,2016-04-01
1254,CALÚNIA - DIFAMAÇÃO - INJÚRIA,266,248,715,1229,2016-04-01
1255,CONSTRANGIMENTO ILEGAL,2,2,4,8,2016-04-01
1256,AMEAÇA,880,828,3486,5194,2016-04-01
1257,INVASÃO DE DOMICÍLIO,0,2,14,16,2016-04-01
1258,DANO,12,12,57,81,2016-04-01
1259,ESTUPRO CONSUMADO,9,9,20,38,2016-04-01
1260,ESTUPRO TENTADO,0,1,3,4,2016-04-01
1261,ESTUPRO DE VULNERÁVEL CONSUMADO,7,10,23,40,2016-04-01
1262,OUTROS C/C/ DIGNIDADE SEXUAL,3,0,2,5,2016-04-01
1263,HOMICÍDIO DOLOSO (exclui FEMINICÍDIO),0,0,5,5,2016-03-01
1264,HOMICÍDIO CULPOSO,0,0,0,0,2016-03-01
1265,TENTATIVA DE HOMICÍDIO,6,6,24,36,2016-03-01
1266,LESÃO CORPORAL DOLOSA,947,855,3056,4858,2016-03-01
1267,MAUS TRATOS,5,5,30,40,2016-03-01
1268,CALÚNIA - DIFAMAÇÃO - INJÚRIA,293,227,913,1433,2016-03-01
1269,CONSTRANGIMENTO ILEGAL,18,1,7,26,2016-03-01
1270,AMEAÇA,958,857,3799,5614,2016-03-01
1271,INVASÃO DE DOMICÍLIO,4,4,27,35,2016-03-01
1272,DANO,11,7,47,65,2016-03-01
1273,ESTUPRO CONSUMADO,10,5,23,38,2016-03-01
1274,ESTUPRO TENTADO,0,0,4,4,2016-03-01
1275,ESTUPRO DE VULNERÁVEL CONSUMADO,8,7,24,39,2016-03-01
1276,OUTROS C/C/ DIGNIDADE SEXUAL,0,0,4,4,2016-03-01
1277,HOMICÍDIO DOLOSO (exclui FEMINICÍDIO),5,0,2,7,2016-02-01
1278,HOMICÍDIO CULPOSO,1,1,0,2,2016-02-01
1279,TENTATIVA DE HOMICÍDIO,4,5,16,25,2016-02-01
1280,LESÃO CORPORAL DOLOSA,833,898,3233,4964,2016-02-01
1281,MAUS TRATOS,2,5,28,35,2016-02-01
1282,CALÚNIA - DIFAMAÇÃO - INJÚRIA,273,260,781,1314,2016-02-01
1283,CONSTRANGIMENTO ILEGAL,2,5,2,9,2016-02-01
1284,AMEAÇA,812,817,3537,5166,2016-02-01
1285,INVASÃO DE DOMICÍLIO,0,4,81,85,2016-02-01
1286,DANO,9,10,65,84,2016-02-01
1287,ESTUPRO CONSUMADO,16,9,26,51,2016-02-01
1288,ESTUPRO TENTADO,1,0,3,4,2016-02-01
1289,ESTUPRO DE VULNERÁVEL CONSUMADO,9,12,18,39,2016-02-01
1290,OUTROS C/C/ DIGNIDADE SEXUAL,0,1,3,4,2016-02-01
1291,HOMICÍDIO DOLOSO (exclui FEMINICÍDIO),4,1,5,10,2016-01-01
1292,HOMICÍDIO CULPOSO,0,0,1,1,2016-01-01
1293,TENTATIVA DE HOMICÍDIO,4,3,23,30,2016-01-01
1294,LESÃO CORPORAL DOLOSA,722,719,2898,4339,2016-01-01
1295,MAUS TRATOS,4,3,20,27,2016-01-01
1296,CALÚNIA - DIFAMAÇÃO - INJÚRIA,206,201,738,1145,2016-01-01
1297,CONSTRANGIMENTO ILEGAL,3,2,3,8,2016-01-01
1298,AMEAÇA,664,804,3413,4881,2016-01-01
1299,INVASÃO DE DOMICÍLIO,0,5,18,23,2016-01-01
1300,DANO,8,11,55,74,2016-01-01
1301,ESTUPRO CONSUMADO,10,6,25,41,2016-01-01
1302,ESTUPRO TENTADO,1,0,1,2,2016-01-01
1303,ESTUPRO DE VULNERÁVEL CONSUMADO,7,4,15,26,2016-01-01
1304,OUTROS C/C/ DIGNIDADE SEXUAL,1,0,2,3,2016-01-01
1305,HOMICÍDIO DOLOSO (exclui FEMINICÍDIO),3,0,5,8,2015-12-01
1306,HOMICÍDIO CULPOSO,0,0,0,0,2015-12-01
1307,TENTATIVA DE HOMICÍDIO,3,5,12,20,2015-12-01
1308,LESÃO CORPORAL DOLOSA,864,810,3022,4696,2015-12-01
1309,MAUS TRATOS,5,1,17,23,2015-12-01
1310,CALÚNIA - DIFAMAÇÃO - INJÚRIA,251,201,735,1187,2015-12-01
1311,CONSTRANGIMENTO ILEGAL,3,16,24,43,2015-12-01
1312,AMEAÇA,803,759,3517,5079,2015-12-01
1313,INVASÃO DE DOMICÍLIO,2,6,51,59,2015-12-01
1314,DANO,9,11,51,71,2015-12-01
1315,ESTUPRO CONSUMADO,14,9,27,50,2015-12-01
1316,ESTUPRO TENTADO,2,1,1,4,2015-12-01
1317,ESTUPRO DE VULNERÁVEL CONSUMADO,14,9,8,31,2015-12-01
1318,OUTROS C/C/ DIGNIDADE SEXUAL,2,0,2,4,2015-12-01
1319,HOMICÍDIO DOLOSO (exclui FEMINICÍDIO),1,1,2,4,2015-11-01
1320,HOMICÍDIO CULPOSO,0,0,0,0,2015-11-01
1321,TENTATIVA DE HOMICÍDIO,4,5,13,22,2015-11-01
1322,LESÃO CORPORAL DOLOSA,797,867,3009,4673,2015-11-01
1323,MAUS TRATOS,4,6,22,32,2015-11-01
1324,CALÚNIA - DIFAMAÇÃO - INJÚRIA,221,239,733,1193,2015-11-01
1325,CONSTRANGIMENTO ILEGAL,0,4,2,6,2015-11-01
1326,AMEAÇA,794,774,3498,5066,2015-11-01
1327,INVASÃO DE DOMICÍLIO,1,5,21,27,2015-11-01
1328,DANO,15,26,53,94,2015-11-01
1329,ESTUPRO CONSUMADO,12,6,23,41,2015-11-01
1330,ESTUPRO TENTADO,2,1,2,5,2015-11-01
1331,ESTUPRO DE VULNERÁVEL CONSUMADO,13,6,20,39,2015-11-01
1332,OUTROS C/C/ DIGNIDADE SEXUAL,1,0,3,4,2015-11-01
1333,HOMICÍDIO DOLOSO (exclui FEMINICÍDIO),1,3,3,7,2015-10-01
1334,HOMICÍDIO CULPOSO,0,0,0,0,2015-10-01
1335,TENTATIVA DE HOMICÍDIO,5,3,21,29,2015-10-01
1336,LESÃO CORPORAL DOLOSA,881,878,3009,4768,2015-10-01
1337,MAUS TRATOS,6,9,37,52,2015-10-01
1338,CALÚNIA - DIFAMAÇÃO - INJÚRIA,263,260,737,1260,2015-10-01
1339,CONSTRANGIMENTO ILEGAL,0,4,16,20,2015-10-01
1340,AMEAÇA,850,916,3618,5384,2015-10-01
1341,INVASÃO DE DOMICÍLIO,4,3,22,29,2015-10-01
1342,DANO,8,14,72,94,2015-10-01
1343,ESTUPRO CONSUMADO,12,6,23,41,2015-10-01
1344,ESTUPRO TENTADO,1,0,1,2,2015-10-01
1345,ESTUPRO DE VULNERÁVEL CONSUMADO,17,2,23,42,2015-10-01
1346,OUTROS C/C/ DIGNIDADE SEXUAL,1,0,4,5,2015-10-01
1347,HOMICÍDIO DOLOSO (exclui FEMINICÍDIO),3,2,7,12,2015-09-01
1348,HOMICÍDIO CULPOSO,0,0,0,0,2015-09-01
1349,TENTATIVA DE HOMICÍDIO,3,6,17,26,2015-09-01
1350,LESÃO CORPORAL DOLOSA,771,798,2629,4198,2015-09-01
1351,MAUS TRATOS,1,2,34,37,2015-09-01
1352,CALÚNIA - DIFAMAÇÃO - INJÚRIA,262,218,757,1237,2015-09-01
1353,CONSTRANGIMENTO ILEGAL,0,11,0,11,2015-09-01
1354,AMEAÇA,833,737,3257,4827,2015-09-01
1355,INVASÃO DE DOMICÍLIO,5,9,24,38,2015-09-01
1356,DANO,7,14,59,80,2015-09-01
1357,ESTUPRO CONSUMADO,4,9,25,38,2015-09-01
1358,ESTUPRO TENTADO,1,0,3,4,2015-09-01
1359,ESTUPRO DE VULNERÁVEL CONSUMADO,17,5,15,37,2015-09-01
1360,OUTROS C/C/ DIGNIDADE SEXUAL,1,0,4,5,2015-09-01
1361,HOMICÍDIO DOLOSO (exclui FEMINICÍDIO),0,1,3,4,2015-08-01
1362,HOMICÍDIO CULPOSO,2,0,1,3,2015-08-01
1363,TENTATIVA DE HOMICÍDIO,1,3,14,18,2015-08-01
1364,LESÃO CORPORAL DOLOSA,800,781,2630,4211,2015-08-01
1365,MAUS TRATOS,6,5,28,39,2015-08-01
1366,CALÚNIA - DIFAMAÇÃO - INJÚRIA,209,171,726,1106,2015-08-01
1367,CONSTRANGIMENTO ILEGAL,2,3,5,10,2015-08-01
1368,AMEAÇA,723,699,3258,4680,2015-08-01
1369,INVASÃO DE DOMICÍLIO,0,5,26,31,2015-08-01
1370,DANO,12,7,61,80,2015-08-01
1371,ESTUPRO CONSUMADO,17,5,14,36,2015-08-01
1372,ESTUPRO TENTADO,2,0,1,3,2015-08-01
1373,ESTUPRO DE VULNERÁVEL CONSUMADO,5,14,12,31,2015-08-01
1374,OUTROS C/C/ DIGNIDADE SEXUAL,0,0,1,1,2015-08-01
1375,HOMICÍDIO DOLOSO (exclui FEMINICÍDIO),0,1,6,7,2015-07-01
1376,HOMICÍDIO CULPOSO,0,0,0,0,2015-07-01
1377,TENTATIVA DE HOMICÍDIO,2,4,15,21,2015-07-01
1378,LESÃO CORPORAL DOLOSA,768,687,2184,3639,2015-07-01
1379,MAUS TRATOS,0,4,23,27,2015-07-01
1380,CALÚNIA - DIFAMAÇÃO - INJÚRIA,200,168,678,1046,2015-07-01
1381,CONSTRANGIMENTO ILEGAL,1,0,5,6,2015-07-01
1382,AMEAÇA,753,641,3131,4525,2015-07-01
1383,INVASÃO DE DOMICÍLIO,0,1,22,23,2015-07-01
1384,DANO,13,5,50,68,2015-07-01
1385,ESTUPRO CONSUMADO,14,7,16,37,2015-07-01
1386,ESTUPRO TENTADO,2,0,3,5,2015-07-01
1387,ESTUPRO DE VULNERÁVEL CONSUMADO,14,3,11,28,2015-07-01
1388,OUTROS C/C/ DIGNIDADE SEXUAL,0,0,0,0,2015-07-01
1389,HOMICÍDIO DOLOSO (exclui FEMINICÍDIO),1,1,5,7,2015-06-01
1390,HOMICÍDIO CULPOSO,14,0,0,14,2015-06-01
1391,TENTATIVA DE HOMICÍDIO,2,4,13,19,2015-06-01
1392,LESÃO CORPORAL DOLOSA,716,712,2324,3752,2015-06-01
1393,MAUS TRATOS,2,3,28,33,2015-06-01
1394,CALÚNIA - DIFAMAÇÃO - INJÚRIA,232,184,706,1122,2015-06-01
1395,CONSTRANGIMENTO ILEGAL,6,2,1,9,2015-06-01
1396,AMEAÇA,759,716,3139,4614,2015-06-01
1397,INVASÃO DE DOMICÍLIO,0,1,13,14,2015-06-01
1398,DANO,14,8,50,72,2015-06-01
1399,ESTUPRO CONSUMADO,18,6,21,45,2015-06-01
1400,ESTUPRO TENTADO,1,0,5,6,2015-06-01
1401,ESTUPRO DE VULNERÁVEL CONSUMADO,12,4,15,31,2015-06-01
1402,OUTROS C/C/ DIGNIDADE SEXUAL,2,0,2,4,2015-06-01
1403,HOMICÍDIO DOLOSO (exclui FEMINICÍDIO),3,3,1,7,2015-05-01
1404,HOMICÍDIO CULPOSO,1,0,0,1,2015-05-01
1405,TENTATIVA DE HOMICÍDIO,3,4,14,21,2015-05-01
1406,LESÃO CORPORAL DOLOSA,658,694,2549,3901,2015-05-01
1407,MAUS TRATOS,2,5,24,31,2015-05-01
1408,CALÚNIA - DIFAMAÇÃO - INJÚRIA,212,168,649,1029,2015-05-01
1409,CONSTRANGIMENTO ILEGAL,19,39,12,70,2015-05-01
1410,AMEAÇA,665,621,3213,4499,2015-05-01
1411,INVASÃO DE DOMICÍLIO,4,4,14,22,2015-05-01
1412,DANO,13,7,56,76,2015-05-01
1413,ESTUPRO CONSUMADO,10,10,26,46,2015-05-01
1414,ESTUPRO TENTADO,0,1,2,3,2015-05-01
1415,ESTUPRO DE VULNERÁVEL CONSUMADO,10,6,18,34,2015-05-01
1416,OUTROS C/C/ DIGNIDADE SEXUAL,1,0,5,6,2015-05-01
1417,HOMICÍDIO DOLOSO (exclui FEMINICÍDIO),2,0,6,8,2015-04-01
1418,HOMICÍDIO CULPOSO,2,0,1,3,2015-04-01
1419,TENTATIVA DE HOMICÍDIO,4,2,16,22,2015-04-01
1420,LESÃO CORPORAL DOLOSA,698,740,2587,4025,2015-04-01
1421,MAUS TRATOS,2,5,24,31,2015-04-01
1422,CALÚNIA - DIFAMAÇÃO - INJÚRIA,236,168,711,1115,2015-04-01
1423,CONSTRANGIMENTO ILEGAL,1,1,19,21,2015-04-01
1424,AMEAÇA,718,710,3277,4705,2015-04-01
1425,INVASÃO DE DOMICÍLIO,12,2,10,24,2015-04-01
1426,DANO,13,10,79,102,2015-04-01
1427,ESTUPRO CONSUMADO,7,6,18,31,2015-04-01
1428,ESTUPRO TENTADO,0,0,2,2,2015-04-01
1429,ESTUPRO DE VULNERÁVEL CONSUMADO,10,7,19,36,2015-04-01
1430,OUTROS C/C/ DIGNIDADE SEXUAL,0,0,0,0,2015-04-01
1431,HOMICÍDIO DOLOSO (exclui FEMINICÍDIO),1,1,6,8,2015-03-01
1432,HOMICÍDIO CULPOSO,0,0,1,1,2015-03-01
1433,TENTATIVA DE HOMICÍDIO,10,4,17,31,2015-03-01
1434,LESÃO CORPORAL DOLOSA,833,807,2725,4365,2015-03-01
1435,MAUS TRATOS,7,4,17,28,2015-03-01
1436,CALÚNIA - DIFAMAÇÃO - INJÚRIA,301,223,732,1256,2015-03-01
1437,CONSTRANGIMENTO ILEGAL,2,1,1,4,2015-03-01
1438,AMEAÇA,967,921,3538,5426,2015-03-01
1439,INVASÃO DE DOMICÍLIO,6,2,17,25,2015-03-01
1440,DANO,16,15,56,87,2015-03-01
1441,ESTUPRO CONSUMADO,21,13,27,61,2015-03-01
1442,ESTUPRO TENTADO,0,1,0,1,2015-03-01
1443,ESTUPRO DE VULNERÁVEL CONSUMADO,7,3,22,32,2015-03-01
1444,OUTROS C/C/ DIGNIDADE SEXUAL,3,0,3,6,2015-03-01
1445,HOMICÍDIO DOLOSO (exclui FEMINICÍDIO),4,1,0,5,2015-02-01
1446,HOMICÍDIO CULPOSO,1,0,4,5,2015-02-01
1447,TENTATIVA DE HOMICÍDIO,2,0,13,15,2015-02-01
1448,LESÃO CORPORAL DOLOSA,751,744,2598,4093,2015-02-01
1449,MAUS TRATOS,2,2,23,27,2015-02-01
1450,CALÚNIA - DIFAMAÇÃO - INJÚRIA,203,175,639,1017,2015-02-01
1451,CONSTRANGIMENTO ILEGAL,1,6,8,15,2015-02-01
1452,AMEAÇA,707,779,3130,4616,2015-02-01
1453,INVASÃO DE DOMICÍLIO,4,0,14,18,2015-02-01
1454,DANO,11,23,50,84,2015-02-01
1455,ESTUPRO CONSUMADO,15,6,22,43,2015-02-01
1456,ESTUPRO TENTADO,0,0,0,0,2015-02-01
1457,ESTUPRO DE VULNERÁVEL CONSUMADO,4,6,17,27,2015-02-01
1458,OUTROS C/C/ DIGNIDADE SEXUAL,1,0,1,2,2015-02-01
1459,HOMICÍDIO DOLOSO (exclui FEMINICÍDIO),2,1,5,8,2015-01-01
1460,HOMICÍDIO CULPOSO,0,0,0,0,2015-01-01
1461,TENTATIVA DE HOMICÍDIO,4,3,21,28,2015-01-01
1462,LESÃO CORPORAL DOLOSA,857,839,3314,5010,2015-01-01
1463,MAUS TRATOS,5,7,21,33,2015-01-01
1464,CALÚNIA - DIFAMAÇÃO - INJÚRIA,199,192,659,1050,2015-01-01
1465,CONSTRANGIMENTO ILEGAL,3,7,8,18,2015-01-01
1466,AMEAÇA,821,858,3726,5405,2015-01-01
1467,INVASÃO DE DOMICÍLIO,2,5,11,18,2015-01-01
1468,DANO,20,16,69,105,2015-01-01
1469,ESTUPRO CONSUMADO,12,5,16,33,2015-01-01
1470,ESTUPRO TENTADO,1,0,7,8,2015-01-01
1471,ESTUPRO DE VULNERÁVEL CONSUMADO,17,9,24,50,2015-01-01
1472,OUTROS C/C/ DIGNIDADE SEXUAL,1,0,1,2,2015-01-01
1473,HOMICÍDIO DOLOSO (exclui FEMINICÍDIO),8,0,8,16,2014-12-01
1474,HOMICÍDIO CULPOSO,0,0,1,1,2014-12-01
1475,TENTATIVA DE HOMICÍDIO,7,6,30,43,2014-12-01
1476,LESÃO CORPORAL DOLOSA,912,823,3085,4820,2014-12-01
1477,MAUS TRATOS,9,6,18,33,2014-12-01
1478,CALÚNIA - DIFAMAÇÃO - INJÚRIA,192,186,595,973,2014-12-01
1479,CONSTRANGIMENTO ILEGAL,0,6,6,12,2014-12-01
1480,AMEAÇA,791,798,3351,4940,2014-12-01
1481,INVASÃO DE DOMICÍLIO,1,5,20,26,2014-12-01
1482,DANO,17,19,75,111,2014-12-01
1483,ESTUPRO CONSUMADO,18,7,14,39,2014-12-01
1484,ESTUPRO TENTADO,1,0,7,8,2014-12-01
1485,ESTUPRO DE VULNERÁVEL CONSUMADO,13,7,28,48,2014-12-01
1486,OUTROS C/C/ DIGNIDADE SEXUAL,1,1,1,3,2014-12-01
1487,HOMICÍDIO DOLOSO (exclui FEMINICÍDIO),1,2,4,7,2014-11-01
1488,HOMICÍDIO CULPOSO,0,0,0,0,2014-11-01
1489,TENTATIVA DE HOMICÍDIO,7,4,14,25,2014-11-01
1490,LESÃO CORPORAL DOLOSA,717,751,2865,4333,2014-11-01
1491,MAUS TRATOS,1,4,21,26,2014-11-01
1492,CALÚNIA - DIFAMAÇÃO - INJÚRIA,185,211,635,1031,2014-11-01
1493,CONSTRANGIMENTO ILEGAL,3,6,7,16,2014-11-01
1494,AMEAÇA,580,802,3346,4728,2014-11-01
1495,INVASÃO DE DOMICÍLIO,1,6,25,32,2014-11-01
1496,DANO,6,10,72,88,2014-11-01
1497,ESTUPRO CONSUMADO,17,8,14,39,2014-11-01
1498,ESTUPRO TENTADO,2,0,3,5,2014-11-01
1499,ESTUPRO DE VULNERÁVEL CONSUMADO,0,10,31,41,2014-11-01
1500,OUTROS C/C/ DIGNIDADE SEXUAL,0,0,3,3,2014-11-01
1501,HOMICÍDIO DOLOSO (exclui FEMINICÍDIO),4,14,5,23,2014-10-01
1502,HOMICÍDIO CULPOSO,2,0,0,2,2014-10-01
1503,TENTATIVA DE HOMICÍDIO,1,5,21,27,2014-10-01
1504,LESÃO CORPORAL DOLOSA,821,798,3109,4728,2014-10-01
1505,MAUS TRATOS,3,10,25,38,2014-10-01
1506,CALÚNIA - DIFAMAÇÃO - INJÚRIA,224,224,885,1333,2014-10-01
1507,CONSTRANGIMENTO ILEGAL,0,7,4,11,2014-10-01
1508,AMEAÇA,800,935,3672,5407,2014-10-01
1509,INVASÃO DE DOMICÍLIO,3,4,10,17,2014-10-01
1510,DANO,10,15,66,91,2014-10-01
1511,ESTUPRO CONSUMADO,18,6,37,61,2014-10-01
1512,ESTUPRO TENTADO,1,0,2,3,2014-10-01
1513,ESTUPRO DE VULNERÁVEL CONSUMADO,20,6,21,47,2014-10-01
1514,OUTROS C/C/ DIGNIDADE SEXUAL,4,0,1,5,2014-10-01
1515,HOMICÍDIO DOLOSO (exclui FEMINICÍDIO),0,2,7,9,2014-09-01
1516,HOMICÍDIO CULPOSO,0,0,0,0,2014-09-01
1517,TENTATIVA DE HOMICÍDIO,5,5,15,25,2014-09-01
1518,LESÃO CORPORAL DOLOSA,777,787,2813,4377,2014-09-01
1519,MAUS TRATOS,3,4,31,38,2014-09-01
1520,CALÚNIA - DIFAMAÇÃO - INJÚRIA,220,245,747,1212,2014-09-01
1521,CONSTRANGIMENTO ILEGAL,2,1,4,7,2014-09-01
1522,AMEAÇA,679,919,3593,5191,2014-09-01
1523,INVASÃO DE DOMICÍLIO,6,0,12,18,2014-09-01
1524,DANO,9,17,69,95,2014-09-01
1525,ESTUPRO CONSUMADO,10,8,15,33,2014-09-01
1526,ESTUPRO TENTADO,0,1,3,4,2014-09-01
1527,ESTUPRO DE VULNERÁVEL CONSUMADO,8,7,27,42,2014-09-01
1528,OUTROS C/C/ DIGNIDADE SEXUAL,2,1,0,3,2014-09-01
1529,HOMICÍDIO DOLOSO (exclui FEMINICÍDIO),1,1,5,7,2014-08-01
1530,HOMICÍDIO CULPOSO,4,0,0,4,2014-08-01
1531,TENTATIVA DE HOMICÍDIO,5,7,7,19,2014-08-01
1532,LESÃO CORPORAL DOLOSA,838,738,2526,4102,2014-08-01
1533,MAUS TRATOS,1,6,29,36,2014-08-01
1534,CALÚNIA - DIFAMAÇÃO - INJÚRIA,222,202,660,1084,2014-08-01
1535,CONSTRANGIMENTO ILEGAL,0,34,10,44,2014-08-01
1536,AMEAÇA,820,738,2992,4550,2014-08-01
1537,INVASÃO DE DOMICÍLIO,1,0,38,39,2014-08-01
1538,DANO,14,12,73,99,2014-08-01
1539,ESTUPRO CONSUMADO,23,12,19,54,2014-08-01
1540,ESTUPRO TENTADO,3,1,0,4,2014-08-01
1541,ESTUPRO DE VULNERÁVEL CONSUMADO,18,7,15,40,2014-08-01
1542,OUTROS C/C/ DIGNIDADE SEXUAL,1,0,3,4,2014-08-01
1543,HOMICÍDIO DOLOSO (exclui FEMINICÍDIO),4,0,4,8,2014-07-01
1544,HOMICÍDIO CULPOSO,0,0,0,0,2014-07-01
1545,TENTATIVA DE HOMICÍDIO,4,2,10,16,2014-07-01
1546,LESÃO CORPORAL DOLOSA,786,702,2602,4090,2014-07-01
1547,MAUS TRATOS,3,2,27,32,2014-07-01
1548,CALÚNIA - DIFAMAÇÃO - INJÚRIA,234,203,633,1070,2014-07-01
1549,CONSTRANGIMENTO ILEGAL,2,4,4,10,2014-07-01
1550,AMEAÇA,809,808,3203,4820,2014-07-01
1551,INVASÃO DE DOMICÍLIO,3,5,17,25,2014-07-01
1552,DANO,12,13,43,68,2014-07-01
1553,ESTUPRO CONSUMADO,11,5,19,35,2014-07-01
1554,ESTUPRO TENTADO,1,0,2,3,2014-07-01
1555,ESTUPRO DE VULNERÁVEL CONSUMADO,8,5,20,33,2014-07-01
1556,OUTROS C/C/ DIGNIDADE SEXUAL,1,0,1,2,2014-07-01
1557,HOMICÍDIO DOLOSO (exclui FEMINICÍDIO),1,0,8,9,2014-06-01
1558,HOMICÍDIO CULPOSO,0,0,1,1,2014-06-01
1559,TENTATIVA DE HOMICÍDIO,2,8,9,19,2014-06-01
1560,LESÃO CORPORAL DOLOSA,745,864,2771,4380,2014-06-01
1561,MAUS TRATOS,0,4,32,36,2014-06-01
1562,CALÚNIA - DIFAMAÇÃO - INJÚRIA,185,212,718,1115,2014-06-01
1563,CONSTRANGIMENTO ILEGAL,2,6,6,14,2014-06-01
1564,AMEAÇA,662,851,3349,4862,2014-06-01
1565,INVASÃO DE DOMICÍLIO,0,2,10,12,2014-06-01
1566,DANO,3,14,55,72,2014-06-01
1567,ESTUPRO CONSUMADO,7,5,15,27,2014-06-01
1568,ESTUPRO TENTADO,1,0,2,3,2014-06-01
1569,ESTUPRO DE VULNERÁVEL CONSUMADO,4,8,18,30,2014-06-01
1570,OUTROS C/C/ DIGNIDADE SEXUAL,0,1,4,5,2014-06-01
1571,HOMICÍDIO DOLOSO (exclui FEMINICÍDIO),1,0,4,5,2014-05-01
1572,HOMICÍDIO CULPOSO,0,0,1,1,2014-05-01
1573,TENTATIVA DE HOMICÍDIO,2,6,21,29,2014-05-01
1574,LESÃO CORPORAL DOLOSA,666,670,2353,3689,2014-05-01
1575,MAUS TRATOS,4,10,17,31,2014-05-01
1576,CALÚNIA - DIFAMAÇÃO - INJÚRIA,147,159,625,931,2014-05-01
1577,CONSTRANGIMENTO ILEGAL,2,7,3,12,2014-05-01
1578,AMEAÇA,651,741,3239,4631,2014-05-01
1579,INVASÃO DE DOMICÍLIO,0,2,21,23,2014-05-01
1580,DANO,9,14,46,69,2014-05-01
1581,ESTUPRO CONSUMADO,6,5,11,22,2014-05-01
1582,ESTUPRO TENTADO,0,0,1,1,2014-05-01
1583,ESTUPRO DE VULNERÁVEL CONSUMADO,5,2,10,17,2014-05-01
1584,OUTROS C/C/ DIGNIDADE SEXUAL,0,0,6,6,2014-05-01
1585,HOMICÍDIO DOLOSO (exclui FEMINICÍDIO),1,0,2,3,2014-04-01
1586,HOMICÍDIO CULPOSO,0,0,0,0,2014-04-01
1587,TENTATIVA DE HOMICÍDIO,0,3,21,24,2014-04-01
1588,LESÃO CORPORAL DOLOSA,702,792,2896,4390,2014-04-01
1589,MAUS TRATOS,0,8,42,50,2014-04-01
1590,CALÚNIA - DIFAMAÇÃO - INJÚRIA,173,215,807,1195,2014-04-01
1591,CONSTRANGIMENTO ILEGAL,1,7,6,14,2014-04-01
1592,AMEAÇA,622,877,3517,5016,2014-04-01
1593,INVASÃO DE DOMICÍLIO,8,1,19,28,2014-04-01
1594,DANO,10,13,55,78,2014-04-01
1595,ESTUPRO CONSUMADO,8,6,32,46,2014-04-01
1596,ESTUPRO TENTADO,0,0,2,2,2014-04-01
1597,ESTUPRO DE VULNERÁVEL CONSUMADO,1,7,22,30,2014-04-01
1598,OUTROS C/C/ DIGNIDADE SEXUAL,0,0,2,2,2014-04-01
1599,HOMICÍDIO DOLOSO (exclui FEMINICÍDIO),0,1,3,4,2014-03-01
1600,HOMICÍDIO CULPOSO,0,0,0,0,2014-03-01
1601,TENTATIVA DE HOMICÍDIO,3,6,25,34,2014-03-01
1602,LESÃO CORPORAL DOLOSA,827,811,3132,4770,2014-03-01
1603,MAUS TRATOS,1,4,17,22,2014-03-01
1604,CALÚNIA - DIFAMAÇÃO - INJÚRIA,181,220,778,1179,2014-03-01
1605,CONSTRANGIMENTO ILEGAL,1,9,6,16,2014-03-01
1606,AMEAÇA,721,906,3701,5328,2014-03-01
1607,INVASÃO DE DOMICÍLIO,0,4,32,36,2014-03-01
1608,DANO,11,12,80,103,2014-03-01
1609,ESTUPRO CONSUMADO,3,10,31,44,2014-03-01
1610,ESTUPRO TENTADO,0,0,0,0,2014-03-01
1611,ESTUPRO DE VULNERÁVEL CONSUMADO,2,4,33,39,2014-03-01
1612,OUTROS C/C/ DIGNIDADE SEXUAL,0,2,4,6,2014-03-01
1613,HOMICÍDIO DOLOSO (exclui FEMINICÍDIO),2,0,6,8,2014-02-01
1614,HOMICÍDIO CULPOSO,0,0,1,1,2014-02-01
1615,TENTATIVA DE HOMICÍDIO,3,3,21,27,2014-02-01
1616,LESÃO CORPORAL DOLOSA,831,787,2788,4406,2014-02-01
1617,MAUS TRATOS,3,7,30,40,2014-02-01
1618,CALÚNIA - DIFAMAÇÃO - INJÚRIA,148,222,686,1056,2014-02-01
1619,CONSTRANGIMENTO ILEGAL,1,15,9,25,2014-02-01
1620,AMEAÇA,766,861,3483,5110,2014-02-01
1621,INVASÃO DE DOMICÍLIO,1,3,9,13,2014-02-01
1622,DANO,10,5,71,86,2014-02-01
1623,ESTUPRO CONSUMADO,10,11,21,42,2014-02-01
1624,ESTUPRO TENTADO,0,0,0,0,2014-02-01
1625,ESTUPRO DE VULNERÁVEL CONSUMADO,1,6,17,24,2014-02-01
1626,OUTROS C/C/ DIGNIDADE SEXUAL,0,0,2,2,2014-02-01
1627,HOMICÍDIO DOLOSO (exclui FEMINICÍDIO),2,0,0,2,2014-01-01
1628,HOMICÍDIO CULPOSO,0,0,0,0,2014-01-01
1629,TENTATIVA DE HOMICÍDIO,3,1,28,32,2014-01-01
1630,LESÃO CORPORAL DOLOSA,904,907,3480,5291,2014-01-01
1631,MAUS TRATOS,0,10,33,43,2014-01-01
1632,CALÚNIA - DIFAMAÇÃO - INJÚRIA,176,206,821,1203,2014-01-01
1633,CONSTRANGIMENTO ILEGAL,2,4,2,8,2014-01-01
1634,AMEAÇA,894,1105,4107,6106,2014-01-01
1635,INVASÃO DE DOMICÍLIO,0,5,17,22,2014-01-01
1636,DANO,10,17,93,120,2014-01-01
1637,ESTUPRO CONSUMADO,14,5,28,47,2014-01-01
1638,ESTUPRO TENTADO,0,1,4,5,2014-01-01
1639,ESTUPRO DE VULNERÁVEL CONSUMADO,3,6,27,36,2014-01-01
1640,OUTROS C/C/ DIGNIDADE SEXUAL,2,0,2,4,2014-01-01
1641,HOMICÍDIO DOLOSO (exclui FEMINICÍDIO),2,1,6,9,2013-12-01
1642,HOMICÍDIO CULPOSO,0,0,0,0,2013-12-01
1643,TENTATIVA DE HOMICÍDIO,0,6,13,19,2013-12-01
1644,LESÃO CORPORAL DOLOSA,963,831,3266,5060,2013-12-01
1645,MAUS TRATOS,0,4,30,34,2013-12-01
1646,CALÚNIA - DIFAMAÇÃO - INJÚRIA,161,166,739,1066,2013-12-01
1647,CONSTRANGIMENTO ILEGAL,0,0,4,4,2013-12-01
1648,AMEAÇA,702,775,3287,4764,2013-12-01
1649,INVASÃO DE DOMICÍLIO,29,0,17,46,2013-12-01
1650,DANO,0,11,70,81,2013-12-01
1651,ESTUPRO CONSUMADO,10,2,15,27,2013-12-01
1652,ESTUPRO TENTADO,0,2,1,3,2013-12-01
1653,ESTUPRO DE VULNERÁVEL CONSUMADO,2,4,14,20,2013-12-01
1654,OUTROS C/C/ DIGNIDADE SEXUAL,0,0,1,1,2013-12-01
1655,HOMICÍDIO DOLOSO (exclui FEMINICÍDIO),1,0,5,6,2013-11-01
1656,HOMICÍDIO CULPOSO,0,0,0,0,2013-11-01
1657,TENTATIVA DE HOMICÍDIO,4,3,12,19,2013-11-01
1658,LESÃO CORPORAL DOLOSA,1027,793,2967,4787,2013-11-01
1659,MAUS TRATOS,1,13,30,44,2013-11-01
1660,CALÚNIA - DIFAMAÇÃO - INJÚRIA,240,210,627,1077,2013-11-01
1661,CONSTRANGIMENTO ILEGAL,0,2,6,8,2013-11-01
1662,AMEAÇA,761,848,3444,5053,2013-11-01
1663,INVASÃO DE DOMICÍLIO,0,3,26,29,2013-11-01
1664,DANO,6,15,54,75,2013-11-01
1665,ESTUPRO CONSUMADO,7,7,36,50,2013-11-01
1666,ESTUPRO TENTADO,0,1,4,5,2013-11-01
1667,ESTUPRO DE VULNERÁVEL CONSUMADO,7,2,22,31,2013-11-01
1668,OUTROS C/C/ DIGNIDADE SEXUAL,0,0,2,2,2013-11-01
1669,HOMICÍDIO DOLOSO (exclui FEMINICÍDIO),2,0,8,10,2013-10-01
1670,HOMICÍDIO CULPOSO,0,0,0,0,2013-10-01
1671,TENTATIVA DE HOMICÍDIO,1,8,22,31,2013-10-01
1672,LESÃO CORPORAL DOLOSA,936,891,3179,5006,2013-10-01
1673,MAUS TRATOS,1,10,22,33,2013-10-01
1674,CALÚNIA - DIFAMAÇÃO - INJÚRIA,206,226,817,1249,2013-10-01
1675,CONSTRANGIMENTO ILEGAL,1,1,4,6,2013-10-01
1676,AMEAÇA,866,899,3599,5364,2013-10-01
1677,INVASÃO DE DOMICÍLIO,1,1,18,20,2013-10-01
1678,DANO,5,21,64,90,2013-10-01
1679,ESTUPRO CONSUMADO,6,7,24,37,2013-10-01
1680,ESTUPRO TENTADO,0,2,3,5,2013-10-01
1681,ESTUPRO DE VULNERÁVEL CONSUMADO,5,5,17,27,2013-10-01
1682,OUTROS C/C/ DIGNIDADE SEXUAL,0,1,2,3,2013-10-01
1683,HOMICÍDIO DOLOSO (exclui FEMINICÍDIO),0,0,30,30,2013-09-01
1684,HOMICÍDIO CULPOSO,0,0,0,0,2013-09-01
1685,TENTATIVA DE HOMICÍDIO,1,8,1,10,2013-09-01
1686,LESÃO CORPORAL DOLOSA,804,742,2845,4391,2013-09-01
1687,MAUS TRATOS,3,10,30,43,2013-09-01
1688,CALÚNIA - DIFAMAÇÃO - INJÚRIA,194,168,738,1100,2013-09-01
1689,CONSTRANGIMENTO ILEGAL,0,2,3,5,2013-09-01
1690,AMEAÇA,877,867,3364,5108,2013-09-01
1691,INVASÃO DE DOMICÍLIO,2,2,14,18,2013-09-01
1692,DANO,6,10,67,83,2013-09-01
1693,ESTUPRO CONSUMADO,7,7,25,39,2013-09-01
1694,ESTUPRO TENTADO,2,2,1,5,2013-09-01
1695,ESTUPRO DE VULNERÁVEL CONSUMADO,8,1,16,25,2013-09-01
1696,OUTROS C/C/ DIGNIDADE SEXUAL,0,0,4,4,2013-09-01
1697,HOMICÍDIO DOLOSO (exclui FEMINICÍDIO),2,1,1,4,2013-08-01
1698,HOMICÍDIO CULPOSO,0,0,1,1,2013-08-01
1699,TENTATIVA DE HOMICÍDIO,1,8,16,25,2013-08-01
1700,LESÃO CORPORAL DOLOSA,836,692,2750,4278,2013-08-01
1701,MAUS TRATOS,4,3,0,7,2013-08-01
1702,CALÚNIA - DIFAMAÇÃO - INJÚRIA,217,202,719,1138,2013-08-01
1703,CONSTRANGIMENTO ILEGAL,4,4,6,14,2013-08-01
1704,AMEAÇA,777,913,3372,5062,2013-08-01
1705,INVASÃO DE DOMICÍLIO,4,1,18,23,2013-08-01
1706,DANO,5,6,67,78,2013-08-01
1707,ESTUPRO CONSUMADO,3,1,19,23,2013-08-01
1708,ESTUPRO TENTADO,1,0,4,5,2013-08-01
1709,ESTUPRO DE VULNERÁVEL CONSUMADO,16,5,4,25,2013-08-01
1710,OUTROS C/C/ DIGNIDADE SEXUAL,0,0,0,0,2013-08-01
1711,HOMICÍDIO DOLOSO (exclui FEMINICÍDIO),0,1,5,6,2013-07-01
1712,HOMICÍDIO CULPOSO,0,0,0,0,2013-07-01
1713,TENTATIVA DE HOMICÍDIO,0,4,15,19,2013-07-01
1714,LESÃO CORPORAL DOLOSA,858,806,2772,4436,2013-07-01
1715,MAUS TRATOS,2,7,22,31,2013-07-01
1716,CALÚNIA - DIFAMAÇÃO - INJÚRIA,160,220,772,1152,2013-07-01
1717,CONSTRANGIMENTO ILEGAL,0,0,4,4,2013-07-01
1718,AMEAÇA,818,811,3326,4955,2013-07-01
1719,INVASÃO DE DOMICÍLIO,1,4,18,23,2013-07-01
1720,DANO,14,16,57,87,2013-07-01
1721,ESTUPRO CONSUMADO,3,4,26,33,2013-07-01
1722,ESTUPRO TENTADO,0,1,2,3,2013-07-01
1723,ESTUPRO DE VULNERÁVEL CONSUMADO,7,7,17,31,2013-07-01
1724,OUTROS C/C/ DIGNIDADE SEXUAL,0,0,2,2,2013-07-01
1725,HOMICÍDIO DOLOSO (exclui FEMINICÍDIO),1,3,3,7,2013-06-01
1726,HOMICÍDIO CULPOSO,0,0,2,2,2013-06-01
1727,TENTATIVA DE HOMICÍDIO,2,1,19,22,2013-06-01
1728,LESÃO CORPORAL DOLOSA,897,719,2790,4406,2013-06-01
1729,MAUS TRATOS,4,4,31,39,2013-06-01
1730,CALÚNIA - DIFAMAÇÃO - INJÚRIA,218,194,691,1103,2013-06-01
1731,CONSTRANGIMENTO ILEGAL,4,22,12,38,2013-06-01
1732,AMEAÇA,747,829,3236,4812,2013-06-01
1733,INVASÃO DE DOMICÍLIO,3,2,19,24,2013-06-01
1734,DANO,6,21,72,99,2013-06-01
1735,ESTUPRO CONSUMADO,4,8,19,31,2013-06-01
1736,ESTUPRO TENTADO,0,0,3,3,2013-06-01
1737,ESTUPRO DE VULNERÁVEL CONSUMADO,2,5,10,17,2013-06-01
1738,OUTROS C/C/ DIGNIDADE SEXUAL,0,0,3,3,2013-06-01
1739,HOMICÍDIO DOLOSO (exclui FEMINICÍDIO),1,0,3,4,2013-05-01
1740,HOMICÍDIO CULPOSO,0,0,0,0,2013-05-01
1741,TENTATIVA DE HOMICÍDIO,0,2,10,12,2013-05-01
1742,LESÃO CORPORAL DOLOSA,897,869,2921,4687,2013-05-01
1743,MAUS TRATOS,2,6,21,29,2013-05-01
1744,CALÚNIA - DIFAMAÇÃO - INJÚRIA,186,231,733,1150,2013-05-01
1745,CONSTRANGIMENTO ILEGAL,1,0,10,11,2013-05-01
1746,AMEAÇA,758,1035,3567,5360,2013-05-01
1747,INVASÃO DE DOMICÍLIO,2,5,20,27,2013-05-01
1748,DANO,8,10,62,80,2013-05-01
1749,ESTUPRO CONSUMADO,9,3,23,35,2013-05-01
1750,ESTUPRO TENTADO,0,0,4,4,2013-05-01
1751,ESTUPRO DE VULNERÁVEL CONSUMADO,3,15,8,26,2013-05-01
1752,OUTROS C/C/ DIGNIDADE SEXUAL,0,0,6,6,2013-05-01
1753,HOMICÍDIO DOLOSO (exclui FEMINICÍDIO),0,2,0,2,2013-04-01
1754,HOMICÍDIO CULPOSO,0,0,0,0,2013-04-01
1755,TENTATIVA DE HOMICÍDIO,6,6,19,31,2013-04-01
1756,LESÃO CORPORAL DOLOSA,954,887,3225,5066,2013-04-01
1757,MAUS TRATOS,4,6,20,30,2013-04-01
1758,CALÚNIA - DIFAMAÇÃO - INJÚRIA,230,257,934,1421,2013-04-01
1759,CONSTRANGIMENTO ILEGAL,0,1,16,17,2013-04-01
1760,AMEAÇA,963,1059,3848,5870,2013-04-01
1761,INVASÃO DE DOMICÍLIO,4,4,21,29,2013-04-01
1762,DANO,9,17,67,93,2013-04-01
1763,ESTUPRO CONSUMADO,7,6,13,26,2013-04-01
1764,ESTUPRO TENTADO,0,1,0,1,2013-04-01
1765,ESTUPRO DE VULNERÁVEL CONSUMADO,3,8,10,21,2013-04-01
1766,OUTROS C/C/ DIGNIDADE SEXUAL,2,0,0,2,2013-04-01
1767,HOMICÍDIO DOLOSO (exclui FEMINICÍDIO),1,0,4,5,2013-03-01
1768,HOMICÍDIO CULPOSO,0,0,0,0,2013-03-01
1769,TENTATIVA DE HOMICÍDIO,0,8,24,32,2013-03-01
1770,LESÃO CORPORAL DOLOSA,860,881,3247,4988,2013-03-01
1771,MAUS TRATOS,1,7,46,54,2013-03-01
1772,CALÚNIA - DIFAMAÇÃO - INJÚRIA,167,209,774,1150,2013-03-01
1773,CONSTRANGIMENTO ILEGAL,6,5,13,24,2013-03-01
1774,AMEAÇA,891,1111,3729,5731,2013-03-01
1775,INVASÃO DE DOMICÍLIO,2,4,23,29,2013-03-01
1776,DANO,5,13,71,89,2013-03-01
1777,ESTUPRO CONSUMADO,10,12,26,48,2013-03-01
1778,ESTUPRO TENTADO,0,1,0,1,2013-03-01
1779,ESTUPRO DE VULNERÁVEL CONSUMADO,4,10,19,33,2013-03-01
1780,OUTROS C/C/ DIGNIDADE SEXUAL,0,0,2,2,2013-03-01
1781,HOMICÍDIO DOLOSO (exclui FEMINICÍDIO),0,1,4,5,2013-02-01
1782,HOMICÍDIO CULPOSO,0,0,7,7,2013-02-01
1783,TENTATIVA DE HOMICÍDIO,2,7,17,26,2013-02-01
1784,LESÃO CORPORAL DOLOSA,896,825,3223,4944,2013-02-01
1785,MAUS TRATOS,1,7,28,36,2013-02-01
1786,CALÚNIA - DIFAMAÇÃO - INJÚRIA,208,218,817,1243,2013-02-01
1787,CONSTRANGIMENTO ILEGAL,1,21,13,35,2013-02-01
1788,AMEAÇA,925,914,3638,5477,2013-02-01
1789,INVASÃO DE DOMICÍLIO,1,3,11,15,2013-02-01
1790,DANO,0,11,60,71,2013-02-01
1791,ESTUPRO CONSUMADO,11,7,21,39,2013-02-01
1792,ESTUPRO TENTADO,0,1,3,4,2013-02-01
1793,ESTUPRO DE VULNERÁVEL CONSUMADO,3,9,19,31,2013-02-01
1794,OUTROS C/C/ DIGNIDADE SEXUAL,0,0,6,6,2013-02-01
1795,HOMICÍDIO DOLOSO (exclui FEMINICÍDIO),1,0,4,5,2013-01-01
1796,HOMICÍDIO CULPOSO,0,0,0,0,2013-01-01
1797,TENTATIVA DE HOMICÍDIO,2,7,22,31,2013-01-01
1798,LESÃO CORPORAL DOLOSA,926,890,3338,5154,2013-01-01
1799,MAUS TRATOS,3,4,34,41,2013-01-01
1800,CALÚNIA - DIFAMAÇÃO - INJÚRIA,206,247,836,1289,2013-01-01
1801,CONSTRANGIMENTO ILEGAL,0,4,10,14,2013-01-01
1802,AMEAÇA,1062,1245,4083,6390,2013-01-01
1803,INVASÃO DE DOMICÍLIO,3,1,19,23,2013-01-01
1804,DANO,10,18,66,94,2013-01-01
1805,ESTUPRO CONSUMADO,7,8,11,26,2013-01-01
1806,ESTUPRO TENTADO,0,0,1,1,2013-01-01
1807,ESTUPRO DE VULNERÁVEL CONSUMADO,2,12,30,44,2013-01-01
1808,OUTROS C/C/ DIGNIDADE SEXUAL,1,1,5,7,2013-01-01
1809,HOMICÍDIO DOLOSO (exclui FEMINICÍDIO),1,0,11,12,2012-12-01
1810,HOMICÍDIO CULPOSO,0,0,0,0,2012-12-01
1811,TENTATIVA DE HOMICÍDIO,0,7,23,30,2012-12-01
1812,LESÃO CORPORAL DOLOSA,997,921,3735,5653,2012-12-01
1813,MAUS TRATOS,3,6,20,29,2012-12-01
1814,CALÚNIA - DIFAMAÇÃO - INJÚRIA,176,239,793,1208,2012-12-01
1815,CONSTRANGIMENTO ILEGAL,0,1,9,10,2012-12-01
1816,AMEAÇA,935,995,3479,5409,2012-12-01
1817,INVASÃO DE DOMICÍLIO,0,2,25,27,2012-12-01
1818,DANO,7,15,67,89,2012-12-01
1819,ESTUPRO CONSUMADO,8,5,23,36,2012-12-01
1820,ESTUPRO TENTADO,0,0,0,0,2012-12-01
1821,ESTUPRO DE VULNERÁVEL CONSUMADO,4,7,13,24,2012-12-01
1822,OUTROS C/C/ DIGNIDADE SEXUAL,0,0,2,2,2012-12-01
1823,HOMICÍDIO DOLOSO (exclui FEMINICÍDIO),0,1,3,4,2012-11-01
1824,HOMICÍDIO CULPOSO,0,0,0,0,2012-11-01
1825,TENTATIVA DE HOMICÍDIO,0,5,14,19,2012-11-01
1826,LESÃO CORPORAL DOLOSA,940,770,3155,4865,2012-11-01
1827,MAUS TRATOS,2,9,19,30,2012-11-01
1828,CALÚNIA - DIFAMAÇÃO - INJÚRIA,198,199,708,1105,2012-11-01
1829,CONSTRANGIMENTO ILEGAL,7,0,6,13,2012-11-01
1830,AMEAÇA,911,916,3432,5259,2012-11-01
1831,INVASÃO DE DOMICÍLIO,2,43,9,54,2012-11-01
1832,DANO,13,12,70,95,2012-11-01
1833,ESTUPRO CONSUMADO,10,6,20,36,2012-11-01
1834,ESTUPRO TENTADO,0,0,3,3,2012-11-01
1835,ESTUPRO DE VULNERÁVEL CONSUMADO,2,11,14,27,2012-11-01
1836,OUTROS C/C/ DIGNIDADE SEXUAL,2,0,4,6,2012-11-01
1837,HOMICÍDIO DOLOSO (exclui FEMINICÍDIO),2,1,3,6,2012-10-01
1838,HOMICÍDIO CULPOSO,0,0,0,0,2012-10-01
1839,TENTATIVA DE HOMICÍDIO,3,7,29,39,2012-10-01
1840,LESÃO CORPORAL DOLOSA,1130,948,3695,5773,2012-10-01
1841,MAUS TRATOS,5,8,55,68,2012-10-01
1842,CALÚNIA - DIFAMAÇÃO - INJÚRIA,230,320,885,1435,2012-10-01
1843,CONSTRANGIMENTO ILEGAL,2,0,6,8,2012-10-01
1844,AMEAÇA,1192,1123,3830,6145,2012-10-01
1845,INVASÃO DE DOMICÍLIO,1,4,10,15,2012-10-01
1846,DANO,6,17,73,96,2012-10-01
1847,ESTUPRO CONSUMADO,21,6,23,50,2012-10-01
1848,ESTUPRO TENTADO,0,2,2,4,2012-10-01
1849,ESTUPRO DE VULNERÁVEL CONSUMADO,10,6,32,48,2012-10-01
1850,OUTROS C/C/ DIGNIDADE SEXUAL,1,0,2,3,2012-10-01
1851,HOMICÍDIO DOLOSO (exclui FEMINICÍDIO),0,2,4,6,2012-09-01
1852,HOMICÍDIO CULPOSO,0,0,1,1,2012-09-01
1853,TENTATIVA DE HOMICÍDIO,2,0,22,24,2012-09-01
1854,LESÃO CORPORAL DOLOSA,946,742,3062,4750,2012-09-01
1855,MAUS TRATOS,5,3,32,40,2012-09-01
1856,CALÚNIA - DIFAMAÇÃO - INJÚRIA,205,163,807,1175,2012-09-01
1857,CONSTRANGIMENTO ILEGAL,0,0,12,12,2012-09-01
1858,AMEAÇA,901,901,3131,4933,2012-09-01
1859,INVASÃO DE DOMICÍLIO,2,6,21,29,2012-09-01
1860,DANO,9,17,64,90,2012-09-01
1861,ESTUPRO CONSUMADO,8,9,39,56,2012-09-01
1862,ESTUPRO TENTADO,0,0,2,2,2012-09-01
1863,ESTUPRO DE VULNERÁVEL CONSUMADO,8,9,13,30,2012-09-01
1864,OUTROS C/C/ DIGNIDADE SEXUAL,4,1,2,7,2012-09-01
1865,HOMICÍDIO DOLOSO (exclui FEMINICÍDIO),0,2,3,5,2012-08-01
1866,HOMICÍDIO CULPOSO,0,0,1,1,2012-08-01
1867,TENTATIVA DE HOMICÍDIO,1,4,16,21,2012-08-01
1868,LESÃO CORPORAL DOLOSA,1189,849,3102,5140,2012-08-01
1869,MAUS TRATOS,3,8,38,49,2012-08-01
1870,CALÚNIA - DIFAMAÇÃO - INJÚRIA,324,284,893,1501,2012-08-01
1871,CONSTRANGIMENTO ILEGAL,2,3,6,11,2012-08-01
1872,AMEAÇA,1135,1037,3702,5874,2012-08-01
1873,INVASÃO DE DOMICÍLIO,1,4,23,28,2012-08-01
1874,DANO,9,15,73,97,2012-08-01
1875,ESTUPRO CONSUMADO,9,5,30,44,2012-08-01
1876,ESTUPRO TENTADO,0,0,2,2,2012-08-01
1877,ESTUPRO DE VULNERÁVEL CONSUMADO,12,8,15,35,2012-08-01
1878,OUTROS C/C/ DIGNIDADE SEXUAL,0,1,3,4,2012-08-01
1879,HOMICÍDIO DOLOSO (exclui FEMINICÍDIO),1,0,5,6,2012-07-01
1880,HOMICÍDIO CULPOSO,0,0,2,2,2012-07-01
1881,TENTATIVA DE HOMICÍDIO,2,3,16,21,2012-07-01
1882,LESÃO CORPORAL DOLOSA,844,897,2931,4672,2012-07-01
1883,MAUS TRATOS,8,3,17,28,2012-07-01
1884,CALÚNIA - DIFAMAÇÃO - INJÚRIA,180,284,836,1300,2012-07-01
1885,CONSTRANGIMENTO ILEGAL,1,4,10,15,2012-07-01
1886,AMEAÇA,863,1005,3231,5099,2012-07-01
1887,INVASÃO DE DOMICÍLIO,1,6,15,22,2012-07-01
1888,DANO,10,9,69,88,2012-07-01
1889,ESTUPRO CONSUMADO,8,9,17,34,2012-07-01
1890,ESTUPRO TENTADO,0,0,1,1,2012-07-01
1891,ESTUPRO DE VULNERÁVEL CONSUMADO,2,5,14,21,2012-07-01
1892,OUTROS C/C/ DIGNIDADE SEXUAL,0,0,2,2,2012-07-01
1893,HOMICÍDIO DOLOSO (exclui FEMINICÍDIO),1,0,3,4,2012-06-01
1894,HOMICÍDIO CULPOSO,0,0,0,0,2012-06-01
1895,TENTATIVA DE HOMICÍDIO,1,3,5,9,2012-06-01
1896,LESÃO CORPORAL DOLOSA,827,774,2758,4359,2012-06-01
1897,MAUS TRATOS,3,14,17,34,2012-06-01
1898,CALÚNIA - DIFAMAÇÃO - INJÚRIA,175,221,897,1293,2012-06-01
1899,CONSTRANGIMENTO ILEGAL,0,1,7,8,2012-06-01
1900,AMEAÇA,877,895,3305,5077,2012-06-01
1901,INVASÃO DE DOMICÍLIO,22,2,15,39,2012-06-01
1902,DANO,5,9,67,81,2012-06-01
1903,ESTUPRO CONSUMADO,9,9,28,46,2012-06-01
1904,ESTUPRO TENTADO,0,1,2,3,2012-06-01
1905,ESTUPRO DE VULNERÁVEL CONSUMADO,3,7,18,28,2012-06-01
1906,OUTROS C/C/ DIGNIDADE SEXUAL,1,1,3,5,2012-06-01
1907,HOMICÍDIO DOLOSO (exclui FEMINICÍDIO),1,0,3,4,2012-05-01
1908,HOMICÍDIO CULPOSO,0,0,1,1,2012-05-01
1909,TENTATIVA DE HOMICÍDIO,0,3,30,33,2012-05-01
1910,LESÃO CORPORAL DOLOSA,914,888,3260,5062,2012-05-01
1911,MAUS TRATOS,4,11,47,62,2012-05-01
1912,CALÚNIA - DIFAMAÇÃO - INJÚRIA,175,239,934,1348,2012-05-01
1913,CONSTRANGIMENTO ILEGAL,1,3,6,10,2012-05-01
1914,AMEAÇA,975,1065,3877,5917,2012-05-01
1915,INVASÃO DE DOMICÍLIO,1,44,18,63,2012-05-01
1916,DANO,5,6,73,84,2012-05-01
1917,ESTUPRO CONSUMADO,13,13,42,68,2012-05-01
1918,ESTUPRO TENTADO,0,5,1,6,2012-05-01
1919,ESTUPRO DE VULNERÁVEL CONSUMADO,3,7,24,34,2012-05-01
1920,OUTROS C/C/ DIGNIDADE SEXUAL,2,0,10,12,2012-05-01
1921,HOMICÍDIO DOLOSO (exclui FEMINICÍDIO),0,2,3,5,2012-04-01
1922,HOMICÍDIO CULPOSO,0,0,0,0,2012-04-01
1923,TENTATIVA DE HOMICÍDIO,4,9,15,28,2012-04-01
1924,LESÃO CORPORAL DOLOSA,981,887,3270,5138,2012-04-01
1925,MAUS TRATOS,4,6,24,34,2012-04-01
1926,CALÚNIA - DIFAMAÇÃO - INJÚRIA,184,204,840,1228,2012-04-01
1927,CONSTRANGIMENTO ILEGAL,1,12,6,19,2012-04-01
1928,AMEAÇA,1016,910,3614,5540,2012-04-01
1929,INVASÃO DE DOMICÍLIO,1,2,17,20,2012-04-01
1930,DANO,4,8,84,96,2012-04-01
1931,ESTUPRO CONSUMADO,16,5,22,43,2012-04-01
1932,ESTUPRO TENTADO,0,1,1,2,2012-04-01
1933,ESTUPRO DE VULNERÁVEL CONSUMADO,5,5,22,32,2012-04-01
1934,OUTROS C/C/ DIGNIDADE SEXUAL,2,0,1,3,2012-04-01
1935,HOMICÍDIO DOLOSO (exclui FEMINICÍDIO),9,2,4,15,2012-03-01
1936,HOMICÍDIO CULPOSO,0,0,0,0,2012-03-01
1937,TENTATIVA DE HOMICÍDIO,2,0,15,17,2012-03-01
1938,LESÃO CORPORAL DOLOSA,1169,1006,3468,5643,2012-03-01
1939,MAUS TRATOS,11,5,37,53,2012-03-01
1940,CALÚNIA - DIFAMAÇÃO - INJÚRIA,271,276,1013,1560,2012-03-01
1941,CONSTRANGIMENTO ILEGAL,11,0,8,19,2012-03-01
1942,AMEAÇA,1344,1095,3922,6361,2012-03-01
1943,INVASÃO DE DOMICÍLIO,1,1,20,22,2012-03-01
1944,DANO,5,12,82,99,2012-03-01
1945,ESTUPRO CONSUMADO,32,4,25,61,2012-03-01
1946,ESTUPRO TENTADO,0,2,5,7,2012-03-01
1947,ESTUPRO DE VULNERÁVEL CONSUMADO,7,4,15,26,2012-03-01
1948,OUTROS C/C/ DIGNIDADE SEXUAL,0,0,5,5,2012-03-01
1949,HOMICÍDIO DOLOSO (exclui FEMINICÍDIO),4,1,4,9,2012-02-01
1950,HOMICÍDIO CULPOSO,0,0,2,2,2012-02-01
1951,TENTATIVA DE HOMICÍDIO,2,6,16,24,2012-02-01
1952,LESÃO CORPORAL DOLOSA,1291,1075,3741,6107,2012-02-01
1953,MAUS TRATOS,7,7,37,51,2012-02-01
1954,CALÚNIA - DIFAMAÇÃO - INJÚRIA,225,190,981,1396,2012-02-01
1955,CONSTRANGIMENTO ILEGAL,0,45,8,53,2012-02-01
1956,AMEAÇA,1295,1108,3841,6244,2012-02-01
1957,INVASÃO DE DOMICÍLIO,6,2,12,20,2012-02-01
1958,DANO,12,10,64,86,2012-02-01
1959,ESTUPRO CONSUMADO,17,9,29,55,2012-02-01
1960,ESTUPRO TENTADO,0,1,3,4,2012-02-01
1961,ESTUPRO DE VULNERÁVEL CONSUMADO,7,4,34,45,2012-02-01
1962,OUTROS C/C/ DIGNIDADE SEXUAL,2,0,2,4,2012-02-01
1963,HOMICÍDIO DOLOSO (exclui FEMINICÍDIO),0,0,4,4,2012-01-01
1964,HOMICÍDIO CULPOSO,0,0,2,2,2012-01-01
1965,TENTATIVA DE HOMICÍDIO,4,3,21,28,2012-01-01
1966,LESÃO CORPORAL DOLOSA,1295,1197,3751,6243,2012-01-01
1967,MAUS TRATOS,8,7,24,39,2012-01-01
1968,CALÚNIA - DIFAMAÇÃO - INJÚRIA,273,212,874,1359,2012-01-01
1969,CONSTRANGIMENTO ILEGAL,3,1,4,8,2012-01-01
1970,AMEAÇA,1174,1183,3860,6217,2012-01-01
1971,INVASÃO DE DOMICÍLIO,3,3,17,23,2012-01-01
1972,DANO,16,14,65,95,2012-01-01
1973,ESTUPRO CONSUMADO,10,18,19,47,2012-01-01
1974,ESTUPRO TENTADO,0,0,4,4,2012-01-01
1975,ESTUPRO DE VULNERÁVEL CONSUMADO,3,5,17,25,2012-01-01
1976,OUTROS C/C/ DIGNIDADE SEXUAL,0,1,3,4,2012-01-01
1977,HOMICÍDIO DOLOSO (exclui FEMINICÍDIO),2,3,13,18,2011-12-01
1978,HOMICÍDIO CULPOSO,0,0,0,0,2011-12-01
1979,TENTATIVA DE HOMICÍDIO,0,1,15,16,2011-12-01
1980,LESÃO CORPORAL DOLOSA,1412,1245,6420,9077,2011-12-01
1981,MAUS TRATOS,7,8,28,43,2011-12-01
1982,CALÚNIA - DIFAMAÇÃO - INJÚRIA,279,197,1277,1753,2011-12-01
1983,CONSTRANGIMENTO ILEGAL,1,4,30,35,2011-12-01
1984,AMEAÇA,1108,970,5502,7580,2011-12-01
1985,INVASÃO DE DOMICÍLIO,3,3,20,26,2011-12-01
1986,DANO,10,17,98,125,2011-12-01
1987,ESTUPRO CONSUMADO,12,9,45,66,2011-12-01
1988,ESTUPRO TENTADO,1,0,1,2,2011-12-01
1989,ESTUPRO DE VULNERÁVEL CONSUMADO,2,7,24,33,2011-12-01
1990,OUTROS C/C/ DIGNIDADE SEXUAL,4,0,5,9,2011-12-01
1991,HOMICÍDIO DOLOSO (exclui FEMINICÍDIO),2,0,6,8,2011-11-01
1992,HOMICÍDIO CULPOSO,0,0,0,0,2011-11-01
1993,TENTATIVA DE HOMICÍDIO,4,5,14,23,2011-11-01
1994,LESÃO CORPORAL DOLOSA,1236,1092,3656,5984,2011-11-01
1995,MAUS TRATOS,11,8,49,68,2011-11-01
1996,CALÚNIA - DIFAMAÇÃO - INJÚRIA,262,145,918,1325,2011-11-01
1997,CONSTRANGIMENTO ILEGAL,5,0,9,14,2011-11-01
1998,AMEAÇA,1077,865,3591,5533,2011-11-01
1999,INVASÃO DE DOMICÍLIO,0,4,24,28,2011-11-01
2000,DANO,7,12,59,78,2011-11-01
2001,ESTUPRO CONSUMADO,17,8,14,39,2011-11-01
2002,ESTUPRO TENTADO,0,0,0,0,2011-11-01
2003,ESTUPRO DE VULNERÁVEL CONSUMADO,2,3,20,25,2011-11-01
2004,OUTROS C/C/ DIGNIDADE SEXUAL,3,0,4,7,2011-11-01
2005,HOMICÍDIO DOLOSO (exclui FEMINICÍDIO),2,1,5,8,2011-10-01
2006,HOMICÍDIO CULPOSO,0,1,1,2,2011-10-01
2007,TENTATIVA DE HOMICÍDIO,5,7,22,34,2011-10-01
2008,LESÃO CORPORAL DOLOSA,1244,1098,3734,6076,2011-10-01
2009,MAUS TRATOS,11,10,43,64,2011-10-01
2010,CALÚNIA - DIFAMAÇÃO - INJÚRIA,254,173,806,1233,2011-10-01
2011,CONSTRANGIMENTO ILEGAL,0,1,22,23,2011-10-01
2012,AMEAÇA,1093,997,3443,5533,2011-10-01
2013,INVASÃO DE DOMICÍLIO,1,5,22,28,2011-10-01
2014,DANO,13,19,76,108,2011-10-01
2015,ESTUPRO CONSUMADO,8,12,23,43,2011-10-01
2016,ESTUPRO TENTADO,1,1,2,4,2011-10-01
2017,ESTUPRO DE VULNERÁVEL CONSUMADO,8,9,22,39,2011-10-01
2018,OUTROS C/C/ DIGNIDADE SEXUAL,1,0,6,7,2011-10-01
2019,HOMICÍDIO DOLOSO (exclui FEMINICÍDIO),0,2,4,6,2011-09-01
2020,HOMICÍDIO CULPOSO,0,0,0,0,2011-09-01
2021,TENTATIVA DE HOMICÍDIO,5,0,11,16,2011-09-01
2022,LESÃO CORPORAL DOLOSA,1198,1040,3606,5844,2011-09-01
2023,MAUS TRATOS,8,5,43,56,2011-09-01
2024,CALÚNIA - DIFAMAÇÃO - INJÚRIA,210,202,846,1258,2011-09-01
2025,CONSTRANGIMENTO ILEGAL,0,4,6,10,2011-09-01
2026,AMEAÇA,1087,977,3705,5769,2011-09-01
2027,INVASÃO DE DOMICÍLIO,1,1,19,21,2011-09-01
2028,DANO,10,10,85,105,2011-09-01
2029,ESTUPRO CONSUMADO,19,13,16,48,2011-09-01
2030,ESTUPRO TENTADO,1,1,2,4,2011-09-01
2031,ESTUPRO DE VULNERÁVEL CONSUMADO,2,8,20,30,2011-09-01
2032,OUTROS C/C/ DIGNIDADE SEXUAL,3,0,3,6,2011-09-01
